Abalistes_stellatus	T	F	F
Abudefduf_luridus	F	F	F
Acantharchus_pomotis	F	T	F
Acanthemblemaria_aspera	T	F	F
Acanthemblemaria_betinensis	T	F	F
Acanthemblemaria_castroi	T	F	F
Acanthemblemaria_chaplini	T	F	F
Acanthemblemaria_crockeri	T	F	F
Acanthemblemaria_exilispinus	T	F	F
Acanthemblemaria_greenfieldi	T	F	F
Acanthemblemaria_hancocki	T	F	F
Acanthemblemaria_macrospilus	T	F	F
Acanthemblemaria_rivasi	T	F	F
Acanthocybium_solandri	T	F	F
Acantholabrus_palloni	T	F	F
Acanthostracion_polygonius	T	F	F
Acanthostracion_quadricornis	T	F	F
Acanthurus_achilles	T	F	F
Acanthurus_auranticavus	T	F	F
Acanthurus_bahianus	T	F	F
Acanthurus_bariene	T	F	F
Acanthurus_blochii	T	F	F
Acanthurus_chirurgus	T	F	F
Acanthurus_coeruleus	T	F	F
Acanthurus_guttatus	T	F	F
Acanthurus_japonicus	T	F	F
Acanthurus_leucocheilus	T	F	F
Acanthurus_leucosternon	T	F	F
Acanthurus_lineatus	T	F	F
Acanthurus_mata	T	F	F
Acanthurus_monroviae	T	F	F
Acanthurus_nigricans	T	F	F
Acanthurus_nigricauda	T	F	F
Acanthurus_nigrofuscus	T	F	F
Acanthurus_olivaceus	T	F	F
Acanthurus_pyroferus	T	F	F
Acanthurus_tennentii	T	F	F
Acanthurus_thompsoni	T	F	F
Acanthurus_triostegus	T	F	F
Acanthurus_xanthopterus	T	F	F
Acantopsis_choirorhynchos	F	F	F
Acentrogobius_pflaumii	T	F	T
Acheilognathus_tabira	F	T	F
Acheilognathus_typus	F	T	F
Acheilognathus_tabira_tabira	F	F	F
Acreichthys_tomentosus	T	F	F
Acrocheilus_alutaceus	F	T	F
Acrossocheilus_monticola	F	T	F
Aethotaxis_mitopteryx	T	F	F
Aethotaxis_mitopteryx_mitopteryx	F	F	F
Afurcagobius_tamarensis	F	T	T
Agosia_chrysogaster	F	T	F
Akarotaxis_nudiceps	T	F	F
Akihito_futuna	T	T	T
Akihito_vanuatu	T	T	T
Akrokolioplax_bicornis	F	F	F
Alburnus_alburnus	F	T	F
Alepocephalus_owstoni	T	F	F
Algansea_avia	F	T	F
Algansea_lacustris	F	T	F
Algansea_monticola	F	T	F
Algansea_tincella	F	T	F
Allomycterus_pilatus	T	F	F
Alosa_alosa	T	T	T
Alosa_fallax	T	T	T
Alticus_saliens	T	F	F
Altolamprologus_compressiceps	F	T	F
Aluterus_heudelotii	T	F	F
Aluterus_monoceros	T	F	F
Aluterus_schoepfii	T	F	F
Aluterus_scriptus	T	F	F
Ambloplites_ariommus	F	T	F
Ambloplites_cavifrons	F	T	F
Ambloplites_constellatus	F	T	F
Ambloplites_rupestris	F	T	F
Amblycirrhitus_bimacula	T	F	F
Amblyeleotris_fasciata	T	F	F
Amblyeleotris_guttata	T	F	F
Amblyeleotris_gymnocephala	T	F	T
Amblyeleotris_periophthalma	T	F	F
Amblyeleotris_randalli	T	F	F
Amblyeleotris_steinitzi	T	F	F
Amblyeleotris_wheeleri	T	F	F
Amblyeleotris_yanoi	T	F	F
Amblygobius_nocturnus	T	F	F
Amblygobius_phalaena	T	F	F
Amblyopsis_rosae	F	F	F
Amblyopsis_spelaea	F	T	F
Amblypharyngodon_chulabhornae	F	T	F
Amblypharyngodon_mola	F	T	F
Amia_calva	F	T	F
Ammodytes_tobianus	T	F	F
Amphiprion_melanopus	T	F	F
Anablepsoides_hartii	F	T	T
Anablepsoides_iridescens	F	T	F
Anablepsoides_ophiomimus	F	T	F
Anarhichas_minor	T	F	F
Andamia_reyi	T	F	F
Andamia_tetradactylus	T	F	F
Andinoacara_biseriatus	F	T	F
Andinoacara_coeruleopunctatus	F	T	F
Andinoacara_latifrons	F	T	F
Andinoacara_pulcher	F	T	F
Andinoacara_stalsbergi	F	T	F
Anguilla_anguilla	T	T	T
Anguilla_japonica	T	T	T
Anoplocapros_inermis	T	F	F
Anoplocapros_lenticularis	T	F	F
Aphredoderus_sayanus	F	T	F
Aphyocypris_chinensis	F	T	F
Aphyosemion_ahli	F	T	F
Aphyosemion_australe	F	T	F
Aphyosemion_bivittatum	F	T	F
Aphyosemion_elberti	F	T	F
Aphyosemion_exigoideum	F	T	F
Aphyosemion_hofmanni	F	T	F
Aphyosemion_louessense	F	T	F
Aphyosemion_ocellatum	F	T	F
Aphyosemion_ogoense	F	T	F
Aphyosemion_primigenium	F	T	F
Aplocheilus_lineatus	F	T	T
Aplochiton_zebra	T	T	T
Aporops_bilinearis	T	F	F
Aracana_aurita	T	F	F
Archoplites_interruptus	F	T	F
Arenigobius_bifrenatus	T	F	T
Argentina_silus	T	F	F
Argentina_sphyraena	T	F	F
Argentina_striata	T	F	F
Arnoglossus_imperialis	T	F	F
Arothron_diadematus	T	F	F
Arothron_hispidus	T	F	T
Arothron_immaculatus	T	F	T
Arothron_manilensis	T	F	T
Arothron_mappa	T	F	F
Arothron_meleagris	T	F	F
Arothron_nigropunctatus	T	F	F
Arothron_stellatus	T	F	F
Artedidraco_lonnbergi	T	F	F
Artedidraco_orianae	T	F	F
Artedidraco_shackletoni	T	F	F
Artedidraco_skottsbergi	T	F	F
Aruma_histrio	T	F	F
Astatotilapia_burtoni	F	T	F
Asterropteryx_ensifera	T	F	T
Asterropteryx_semipunctata	T	F	F
Atherina_boyeri	T	T	T
Atherina_breviceps	T	T	T
Atherina_hepsetus	T	T	T
Atherina_presbyter	T	F	T
Atlantirivulus_haraldsiolii	F	T	F
Atlantirivulus_santensis	F	T	F
Atractoscion_aequidens	T	F	T
Auchenionchus_microcirrhis	T	F	F
Aulopus_filamentosus	T	F	F
Aulostomus_chinensis	T	F	F
Auriglobus_nefastus	F	T	F
Austrofundulus_leohoignei	F	T	F
Austrofundulus_limnaeus	F	T	F
Austrofundulus_transilis	F	T	F
Austrolebias_adloffi	F	T	F
Austrolebias_alexandri	F	T	F
Austrolebias_bellottii	F	T	F
Auxis_rochei	T	F	T
Auxis_thazard	T	F	F
Auxis_rochei_rochei	F	F	F
Auxis_thazard_thazard	F	F	F
Awaous_guamensis	T	T	T
Axoclinus_lucillae	T	F	F
Axoclinus_nigricaudus	T	F	F
Axoclinus_storeyae	T	F	F
Aztecula_sallaei	F	F	F
Babka_gymnotrachelus	F	T	T
Bagarius_yarrelli	F	T	F
Balistapus_undulatus	T	F	F
Balistes_polylepis	T	F	F
Balistes_punctatus	T	F	F
Balistes_vetula	T	F	F
Balistoides_conspicillum	T	F	F
Balistoides_viridescens	T	F	F
Bangana_ariza	F	F	F
Bangana_dero	F	T	F
Bangana_lemassoni	F	T	F
Bangana_lippus	F	F	F
Bangana_pierrei	F	F	F
Bangana_tonkinensis	F	T	F
Barbatula_toni	F	T	F
Barbichthys_laevis	F	T	F
Barbourisia_rufa	T	F	F
Barbulifer_ceuthoecus	T	F	F
Barbus_barbus	F	T	T
Barbus_callipterus	F	T	F
Barbus_fasciolatus	F	T	F
Barbus_leonensis	F	T	F
Barbus_trimaculatus	F	F	F
Barilius_barila	F	T	F
Barilius_canarensis	F	T	F
Barilius_caudiocellatus	F	T	F
Barilius_vagra	F	T	F
Bathydraco_antarcticus	T	F	F
Bathydraco_macrolepis	T	F	F
Bathydraco_marri	T	F	F
Bathydraco_scotiae	T	F	F
Bathygobius_cocosensis	T	F	F
Bathygobius_curacao	T	F	F
Bathygobius_soporator	T	T	T
Bathylagus_euryops	T	F	F
Beaufortia_szechuanensis	F	T	F
Bedotia_geayi	F	T	F
Belone_belone	T	F	T
Belonoperca_chabanaudi	T	F	F
Benthophilus_magistri	F	T	T
Beryx_decadactylus	T	F	F
Beryx_splendens	T	F	F
Betadevario_ramachandrani	F	T	F
Biwia_zezera	F	T	F
Blenniella_chrysospilos	T	F	F
Blenniella_cyanostigma	T	F	F
Blennioclinus_stella	T	F	F
Blennophis_striatus	T	F	F
Bodianus_scrofa	T	F	F
Boops_boops	T	F	T
Boraras_brigittae	F	T	F
Boraras_maculatus	F	T	F
Boraras_urophthalmoides	F	T	F
Bostockia_porosa	F	T	F
Bothus_podas	T	F	F
Botia_dario	F	T	F
Bovichtus_variegatus	T	F	F
Brachaluteres_jacksonianus	T	F	F
Brachymystax_lenok	F	T	F
Brama_brama	T	F	F
Brevibora_dorsiocellata	F	T	F
Brosme_brosme	T	F	F
Brotula_barbata	T	F	F
Bryaninops_yongei	T	F	F
Buglossidium_luteum	T	F	T
Cabillus_tongarevae	T	F	F
Caffrogobius_saldanha	T	F	T
Calliclinus_geniguttatus	T	F	F
Callionymus_filamentosus	T	F	F
Callionymus_lyra	T	F	F
Callionymus_maculatus	T	F	F
Callionymus_reticulatus	T	F	T
Callogobius_bifasciatus	T	F	F
Callogobius_sclateri	T	F	F
Callopanchax_occidentalis	F	T	F
Campellolebias_brucei	F	T	F
Campostoma_anomalum	F	T	F
Campostoma_oligolepis	F	T	F
Campostoma_ornatum	F	T	F
Campostoma_pauciradii	F	T	F
Campostoma_pullum	F	F	F
Candidia_barbata	F	T	F
Cantherhines_pardalis	T	F	F
Cantherhines_pullus	T	F	F
Canthidermis_maculata	T	F	F
Canthigaster_amboinensis	T	F	F
Canthigaster_bennetti	T	F	F
Canthigaster_callisterna	T	F	F
Canthigaster_compressa	T	F	T
Canthigaster_coronata	T	F	F
Canthigaster_figueiredoi	T	F	F
Canthigaster_jactator	T	F	F
Canthigaster_janthinoptera	T	F	F
Canthigaster_leoparda	T	F	F
Canthigaster_papua	T	F	F
Canthigaster_punctatissima	T	F	F
Canthigaster_rivulata	T	F	F
Canthigaster_rostrata	T	F	F
Canthigaster_smithae	T	F	F
Canthigaster_solandri	T	F	F
Canthigaster_valentini	T	F	F
Caprichthys_gymnura	T	F	F
Capropygia_unistriata	T	F	F
Capros_aper	T	F	F
Caracanthus_unipinna	T	F	F
Caranx_crysos	T	F	T
Carapus_boraborensis	F	F	F
Carassius_carassius	F	T	T
Carassius_gibelio	F	T	T
Carinotetraodon_irrubesco	F	T	F
Carinotetraodon_salivator	F	T	F
Carinotetraodon_travancoricus	F	T	F
Catla_catla	F	F	F
Catostomus_commersonii	F	T	F
Centrarchus_macropterus	F	T	F
Centrolophus_niger	T	F	F
Cephalopholis_sonnerati	T	F	F
Ceratias_holboelli	T	F	F
Cerdale_floridana	T	F	T
Cestraeus_oxyrhyncus	T	T	T
Chaenocephalus_aceratus	T	F	F
Chaenodraco_wilsoni	T	F	F
Chaenopsis_limbaughi	T	F	F
Chaenopsis_schmitti	T	F	F
Chaetodermis_penicilligerus	T	F	F
Chaetodon_semilarvatus	T	F	F
Chalceus_macrolepidotus	F	T	F
Champsocephalus_esox	T	F	F
Champsocephalus_gunnari	T	F	F
Channa_striata	F	T	F
Channichthys_rhinoceratus	T	F	F
Chanodichthys_mongolicus	F	T	F
Cheimarrichthys_fosteri	T	T	T
Chela_cachius	F	T	T
Chelaethiops_bibie	F	T	F
Chelaethiops_elongatus	F	T	F
Chelidonichthys_cuculus	T	F	T
Chelidonichthys_lucerna	T	F	T
Chelidonichthys_obscurus	T	F	F
Chelon_labrosus	T	T	T
Chelon_macrolepis	F	F	F
Chelon_subviridis	F	F	F
Chelonodon_patoca	F	F	F
Chelonodon_pleurospilus	F	F	F
Chilomycterus_antennatus	T	F	F
Chilomycterus_antillarum	T	F	F
Chilomycterus_reticulatus	T	F	F
Chilomycterus_schoepfii	T	F	F
Chionobathyscus_dewitti	T	F	F
Chionodraco_hamatus	T	F	F
Chionodraco_myersi	T	F	F
Chionodraco_rastrospinosus	T	F	F
Chlorophthalmus_agassizi	T	F	F
Chloroscombrus_chrysurus	T	F	T
Chologaster_cornuta	F	T	F
Chonerhinos_naritus	F	T	F
Chromis_limbata	T	F	F
Chromobotia_macracanthus	F	T	F
Chrosomus_erythrogaster	F	T	F
Chrysophrys_auratus	T	F	T
Chrysophrys_major	T	F	F
Chuanchia_labiosa	F	T	F
Ciliata_septentrionalis	T	F	F
Cirrhinus_cirrhosus	F	T	T
Cirrhinus_microlepis	F	T	F
Cirrhinus_molitorella	F	T	F
Cirrhinus_mrigala	F	T	F
Cirrhitus_pinnulatus	T	F	F
Cirriemblemaria_lucasana	T	F	F
Cirripectes_castaneus	T	F	F
Cirripectes_filamentosus	T	F	F
Cirripectes_quagga	T	F	F
Cirripectes_stigmaticus	T	F	F
Claea_dabryi	F	F	F
Clinostomus_funduloides	F	T	F
Clinus_arborescens	T	F	F
Clinus_musaicus	T	F	F
Clinus_spatulatus	T	F	F
Clinus_venustris	T	F	F
Clupea_harengus	T	F	T
Cnesterodon_decemmaculatus	F	T	T
Cnesterodon_hypselurus	F	T	F
Cobitis_biwae	F	T	F
Cobitis_shikokuensis	F	T	F
Cobitis_striata	F	T	F
Cobitis_takatsuensis	F	T	F
Codoma_ornata	F	T	F
Colomesus_asellus	T	T	T
Coptodon_bythobathes	F	F	F
Coralliozetus_angelicus	T	F	F
Coralliozetus_boehlkei	T	F	F
Coralliozetus_cardonae	T	F	F
Coralliozetus_micropes	T	F	F
Coralliozetus_springeri	T	F	F
Coregonus_autumnalis	T	T	T
Coreoperca_kawamebari	F	T	F
Coreoperca_loona	F	F	F
Corydoras_rabauti	F	T	F
Coryphaenoides_rupestris	T	F	F
Coryphopterus_dicrus	T	F	F
Coryphopterus_hyalinus	T	F	T
Coryphopterus_personatus	T	F	F
Coryphopterus_punctipectophorus	T	F	F
Cottoperca_gobio	T	F	F
Cottunculus_thomsonii	T	F	F
Cotylopus_acutipinnis	T	T	T
Cotylopus_rubripinnis	T	T	T
Couesius_plumbeus	F	T	F
Cranoglanis_bouderius	F	T	F
Cremnochorites_capensis	T	F	F
Creteuchiloglanis_kamengensis	F	T	F
Cristiceps_australis	T	F	F
Crossocheilus_burmanicus	F	F	F
Crossocheilus_nigriloba	F	T	F
Crossocheilus_oblongus	F	T	F
Crossocheilus_reticulatus	F	T	F
Cryodraco_antarcticus	T	F	F
Cryodraco_atkinsoni	T	F	F
Cryptocentrus_albidorsus	T	F	F
Cryptocentrus_cinctus	T	F	F
Cryptocentrus_inexplicatus	T	F	F
Cryptocentrus_leptocephalus	T	F	F
Cryptocentrus_lutheri	T	F	F
Cryptocentrus_nigrocellatus	T	F	F
Ctenochaetus_binotatus	T	F	F
Ctenochaetus_striatus	T	F	F
Ctenochaetus_strigosus	T	F	F
Ctenochaetus_truncatus	T	F	F
Ctenogobiops_aurocingulus	T	F	F
Ctenogobiops_formosa	T	F	F
Ctenogobiops_mitodes	T	F	F
Ctenogobiops_tangaroai	T	F	F
Ctenogobiops_tongaensis	T	F	F
Ctenopharyngodon_idella	F	T	T
Culter_alburnus	F	T	F
Culter_flavipinnis	F	T	F
Cycleptus_elongatus	F	T	F
Cyclocheilichthys_janthochir	F	T	F
Cyclopterus_lumpus	T	F	F
Cygnodraco_mawsoni	T	F	F
Cynodonichthys_magdalenae	F	T	F
Cynodonichthys_tenuis	F	T	F
Cynoglossus_browni	T	F	F
Cynoglossus_senegalensis	T	F	T
Cynoscion_regalis	T	T	T
Cyprinella_bocagrande	F	T	F
Cyprinella_formosa	F	T	F
Cyprinella_garmani	F	T	F
Cyprinella_lutrensis	F	T	F
Cyprinella_monacha	F	T	F
Cyprinella_proserpina	F	T	F
Cyprinella_rutila	F	T	F
Cyprinella_xanthicara	F	T	F
Cyprinus_carpio	F	T	T
Dacodraco_hunteri	T	F	F
Dactylopterus_volitans	T	F	F
Dactyloscopus_lacteus	T	F	F
Dallia_pectoralis	F	T	F
Danio_aesculapii	F	T	F
Danio_choprae	F	T	F
Danio_dangila	F	T	F
Danio_erythromicron	F	T	F
Danio_feegradei	F	T	F
Danio_kerri	F	T	F
Danio_kyathit	F	T	F
Danio_meghalayensis	F	T	F
Danio_nigrofasciatus	F	T	F
Danio_tinwini	F	T	F
Danionella_dracula	F	T	F
Dawkinsia_arulius	F	T	F
Dawkinsia_assimilis	F	T	F
Dawkinsia_filamentosa	F	T	T
Dawkinsia_tambraparniei	F	T	F
Delminichthys_adspersus	F	T	F
Delminichthys_ghetaldii	F	T	F
Delminichthys_jadovensis	F	T	F
Delminichthys_krbavensis	F	T	F
Dendrochirus_biocellatus	T	F	F
Dentex_angolensis	T	F	F
Dentex_canariensis	T	F	F
Dentex_dentex	T	F	T
Dentex_gibbosus	T	F	T
Dentex_macrophthalmus	T	F	F
Dentex_maroccanus	T	F	F
Devario_aequipinnatus	F	T	F
Devario_annandalei	F	T	F
Devario_apogon	F	T	F
Devario_auropurpureus	F	F	F
Devario_chrysotaeniatus	F	T	F
Devario_devario	F	T	F
Devario_kakhienensis	F	T	F
Devario_laoensis	F	T	F
Devario_maetaengensis	F	F	F
Devario_malabaricus	F	T	F
Devario_pathirana	F	T	F
Devario_shanensis	F	T	F
Devario_sondhii	F	T	F
Devario_xyrops	F	T	F
Dialommus_macrocephalus	T	F	F
Diapterus_auratus	T	T	T
Dicentrarchus_labrax	T	T	T
Dicentrarchus_punctatus	T	T	T
Dicologlossa_cuneata	T	F	T
Diodon_hystrix	T	F	F
Diodon_liturosus	T	F	F
Diodon_nicthemerus	T	F	F
Dionda_argentosa	F	T	F
Dionda_diaboli	F	T	F
Dionda_episcopa	F	T	F
Dionda_melanops	F	T	F
Dionda_nigrotaeniata	F	T	F
Dionda_serena	F	T	F
Diplodus_annularis	T	F	T
Diplodus_cervinus	T	F	F
Diplodus_puntazzo	T	F	T
Diplodus_sargus	T	F	T
Diplodus_vulgaris	T	F	F
Diplodus_cervinus_cervinus	F	F	F
Diplodus_sargus_cadenati	T	F	T
Diplodus_sargus_sargus	F	F	F
Discocheilus_wui	F	T	F
Discogobio_brachyphysallidos	F	T	F
Discogobio_macrophysallidos	F	T	F
Discogobio_tetrabarbatus	F	T	F
Discogobio_yunnanensis	F	T	F
Discolabeo_wuluoheensis	F	T	F
Dissostichus_eleginoides	T	F	F
Dissostichus_mawsoni	T	F	F
Dolloidraco_longedorsalis	T	F	F
Doryrhamphus_excisus	T	F	F
Doryrhamphus_excisus_excisus	F	F	F
Ecsenius_midas	T	F	F
Ecsenius_nalolo	T	F	F
Ecsenius_opsifrontalis	T	F	F
Ecsenius_pardus	T	F	F
Ekemblemaria_myersi	T	F	F
Ekemblemaria_nigra	T	F	F
Elacatinus_atronasus	T	F	F
Elacatinus_chancei	T	F	F
Elacatinus_digueti	F	F	F
Elacatinus_dilepis	F	F	F
Elacatinus_evelynae	T	F	F
Elacatinus_figaro	T	F	F
Elacatinus_genie	T	F	F
Elacatinus_horsti	T	F	F
Elacatinus_illecebrosus	T	F	F
Elacatinus_limbaughi	T	F	F
Elacatinus_lori	T	F	F
Elacatinus_louisae	T	F	F
Elacatinus_oceanops	T	F	F
Elacatinus_pallens	F	F	F
Elacatinus_prochilos	T	F	F
Elacatinus_puncticulatus	T	F	F
Elacatinus_randalli	T	F	F
Elacatinus_xanthiprora	T	F	F
Elassoma_alabamae	F	T	F
Elassoma_boehlkei	F	T	F
Elassoma_gilberti	F	T	F
Electrona_antarctica	T	F	F
Eleginops_maclovinus	T	T	F
Embiotoca_jacksoni	T	F	F
Emblemaria_diphyodontis	T	F	F
Emblemaria_hypacanthus	T	F	F
Emblemaria_nivipes	T	F	F
Emblemaria_pandionis	T	F	F
Emblemaria_piratica	T	F	F
Emblemariopsis_randalli	T	F	F
Emblemariopsis_signifer	T	F	F
Enchelycore_anatina	T	F	F
Engraulicypris_sardella	F	T	F
Enneacanthus_chaetodon	F	T	F
Enneacanthus_gloriosus	F	T	F
Enneacanthus_obesus	F	T	F
Enneanectes_altivelis	T	F	F
Enneanectes_boehlkei	T	F	F
Enneanectes_carminalis	T	F	F
Enneanectes_pectoralis	F	F	F
Enneapterygius_abeli	T	F	F
Enneapterygius_gruschkai	T	F	F
Enneapterygius_tutuilae	T	F	F
Enoplosus_armatus	T	F	F
Entomacrodus_chiostictus	T	F	F
Entomacrodus_nigricans	T	F	F
Entomacrodus_niuafoouensis	T	F	F
Entomacrodus_striatus	T	F	F
Epalzeorhynchos_frenatus	F	F	F
Epalzeorhynchos_kalopterus	F	F	F
Epinephelus_aeneus	T	F	T
Epinephelus_costae	T	F	F
Epinephelus_guttatus	T	F	F
Epinephelus_marginatus	T	F	F
Epinephelus_tauvina	T	F	F
Epiplatys_bifasciatus	F	T	F
Epiplatys_lamottei	F	T	F
Epiplatys_singa	F	T	F
Erimystax_dissimilis	F	T	F
Erythrocles_monodi	T	F	F
Esomus_ahli	F	T	F
Esomus_caudiocellatus	F	T	F
Esomus_danricus	F	F	F
Esomus_metallicus	F	T	T
Esox_lucius	F	T	T
Esox_reichertii	F	T	F
Etroplus_maculatus	F	F	F
Euchiloglanis_kishinouyei	F	T	F
Eucinostomus_gula	T	T	T
Eugerres_plumieri	T	T	T
Euthynnus_alletteratus	T	F	T
Eutrigla_gurnardus	T	F	T
Eviota_afelei	T	F	F
Exerpes_asper	F	F	F
Exoglossum_laurae	F	T	F
Exoglossum_maxillingua	F	T	F
Exostoma_labiatum	F	T	F
Exyrias_belissimus	T	F	F
Favonigobius_exquisitus	T	F	T
Favonigobius_melanobranchus	T	F	F
Fistularia_petimba	T	F	F
Forbesichthys_agassizii	F	T	F
Forbesichthys_papilliferus	F	T	F
Formosania_fascicauda	F	T	F
Forsterygion_lapillum	T	F	F
Fundulopanchax_gardneri	F	T	F
Fundulopanchax_mirabilis	F	T	F
Fundulopanchax_gardneri_gardneri	F	F	F
Fusigobius_duospilus	T	F	F
Fusigobius_neophytus	T	F	F
Fusigobius_signipinnis	T	F	F
Gadiculus_argenteus	T	F	F
Gadus_morhua	T	F	T
Gadus_ogac	T	F	T
Gagata_dolichonema	F	T	F
Gaidropsarus_biscayensis	F	F	F
Gaidropsarus_mediterraneus	T	F	T
Galaxias_brevipinnis	T	T	T
Galaxias_gollumoides	F	T	F
Galaxias_neocaledonicus	F	T	F
Galaxias_paucispondylus	F	T	F
Galaxias_platei	T	T	T
Galaxias_zebratus	F	T	F
Garra_bicornuta	F	T	F
Garra_ceylonensis	F	T	F
Garra_congoensis	F	T	F
Garra_fasciacauda	F	T	F
Garra_flavatra	F	T	F
Garra_fuliginosa	F	T	F
Garra_gotyla	F	T	F
Garra_imberba	F	F	F
Garra_kempi	F	T	F
Garra_lamta	F	T	F
Garra_lissorhynchus	F	T	F
Garra_makiensis	F	T	F
Garra_micropulvinus	F	T	F
Garra_mirofrontis	F	T	F
Garra_mullya	F	T	F
Garra_nasuta	F	T	F
Garra_orientalis	F	T	F
Garra_ornata	F	T	F
Garra_rufa	F	T	F
Garra_spilota	F	T	F
Garra_tengchongensis	F	T	F
Garra_waterloti	F	T	F
Garra_gotyla_gotyla	F	F	F
Gasterochisma_melampus	T	F	F
Gempylus_serpens	T	F	F
Gerlachea_australis	T	F	F
Gerres_cinereus	T	T	T
Gibbonsia_metzi	T	F	F
Gila_atraria	F	T	F
Gila_brevicauda	F	T	F
Gila_coerulea	F	F	F
Gila_conspersa	F	T	F
Gila_cypha	F	T	F
Gila_ditaenia	F	T	F
Gila_elegans	F	T	F
Gila_eremica	F	T	F
Gila_intermedia	F	F	F
Gila_minacae	F	T	F
Gila_modesta	F	T	F
Gila_nigra	F	T	F
Gila_nigrescens	F	T	F
Gila_orcuttii	F	T	F
Gila_pandora	F	T	F
Gila_pulchra	F	T	F
Gila_purpurea	F	T	F
Gila_robusta	F	T	F
Gila_seminuda	F	T	F
Gillellus_uranidea	T	F	F
Ginsburgellus_novemlineatus	T	F	T
Glaridoglanis_andersonii	F	T	F
Glaucosoma_buergeri	T	F	F
Glaucosoma_hebraicum	T	F	F
Glaucosoma_magnificum	T	F	F
Glaucosoma_scapulare	T	F	F
Glyptocephalus_cynoglossus	T	F	F
Glyptosternon_maculatum	F	T	F
Glyptothorax_trilineatus	F	T	F
Gnathodentex_aureolineatus	T	F	F
Gnatholebias_zonatus	F	T	F
Gnatholepis_cauerensis	T	F	T
Gnathopogon_elongatus	F	T	F
Gobiesox_juradoensis	F	T	F
Gobiesox_pinniger	T	F	F
Gobiesox_rhessodon	T	F	F
Gobio_gobio	F	T	T
Gobiodon_histrio	T	F	F
Gobiodon_quinquestrigatus	T	F	F
Gobionotothen_acuta	T	F	F
Gobionotothen_gibberifrons	T	F	F
Gobiosoma_bosc	T	T	T
Gobiosoma_chiquita	T	F	T
Gobius_niger	T	T	T
Gonorynchus_greyi	T	T	T
Grammistops_ocellatus	T	F	F
Gunnellichthys_monostigma	T	F	F
Gymnocephalus_cernua	F	T	T
Gymnocypris_przewalskii	F	F	F
Gymnocypris_waddellii	F	T	F
Gymnodraco_acuticeps	T	F	F
Gymnothorax_bacalladoi	T	F	F
Gymnothorax_maderensis	T	F	F
Gymnothorax_miliaris	T	F	F
Gymnothorax_polygonius	T	F	F
Gymnothorax_unicolor	T	F	F
Gyrinocheilus_aymonieri	F	T	F
Haemulon_aurolineatum	T	F	F
Halobatrachus_didactylus	T	F	T
Haludaria_fasciata	F	T	F
Haplochromis_azureus	F	F	F
Haplochromis_degeni	F	T	F
Haplochromis_nyererei	F	T	F
Harpagifer_antarcticus	T	F	F
Helcogramma_ellioti	T	F	F
Helcogramma_fuscopinna	T	F	F
Helicolenus_dactylopterus	T	F	F
Hemiemblemaria_simulus	T	F	F
Hemigrammocypris_rasborella	F	T	T
Hemitremia_flammea	F	T	F
Henicorhynchus_lineatus	F	T	F
Henicorhynchus_lobatus	F	T	F
Henicorhynchus_ornatipinnis	F	T	F
Henicorhynchus_siamensis	F	T	F
Hesperoleucus_symmetricus	F	T	F
Heteroclinus_adelaidae	T	F	F
Heteropriacanthus_cruentatus	T	F	F
Hippichthys_penicillus	T	T	T
Hippocampus_bargibanti	T	F	F
Hippocampus_breviceps	T	F	T
Hippocampus_erectus	T	F	F
Hippocampus_guttulatus	T	F	T
Hippocampus_hippocampus	T	F	T
Hippocampus_ingens	T	F	F
Hippocampus_patagonicus	T	F	F
Hippocampus_reidi	T	F	F
Hippocampus_zosterae	T	F	F
Hippoglossoides_platessoides	T	F	F
Hippoglossus_hippoglossus	T	F	F
Histiodraco_velifer	T	F	F
Holacanthus_ciliaris	T	F	F
Homaloptera_leonardi	F	T	F
Homaloptera_parclitella	F	T	F
Hongshuia_microstomatus	F	F	F
Hongshuia_paoli	F	T	F
Huso_huso	T	T	T
Hybognathus_nuchalis	F	T	F
Hybognathus_placitus	F	T	F
Hybopsis_winchelli	F	T	F
Hypentelium_nigricans	F	T	F
Hyperoplus_lanceolatus	T	F	F
Hypomesus_nipponensis	T	T	T
Hypophthalmichthys_nobilis	F	T	F
Hyporhamphus_sajori	T	F	T
Hypselobarbus_jerdoni	F	T	F
Hypsoblennius_brevipinnis	T	F	F
Hypsoblennius_caulopus	T	F	F
Hypsoblennius_gentilis	T	F	T
Hypsoblennius_gilberti	T	F	F
Hypsoblennius_hentz	T	F	F
Hypsoblennius_jenkinsi	T	F	F
Hypsolebias_flammeus	F	T	F
Hypsolebias_flavicaudatus	F	T	F
Hypsolebias_magnificus	F	T	F
Ictalurus_punctatus	F	T	F
Idiotropiscis_lumnitzeri	T	F	F
Incisilabeo_behri	F	T	F
Iotichthys_phlegethontis	F	T	F
Iso_natalensis	T	F	F
Istiblennius_dussumieri	T	F	T
Istiblennius_edentulus	T	F	F
Istiblennius_lineatus	T	F	F
Istigobius_decoratus	T	F	F
Istigobius_rigilius	T	F	F
Istiompax_indica	T	F	F
Istiophorus_platypterus	T	F	F
Julidochromis_regani	F	T	F
Kajikia_albida	T	F	F
Kajikia_audax	T	F	F
Kali_macrura	T	F	F
Katsuwonus_pelamis	T	F	F
Kentrocapros_rosapinto	T	F	F
Kichulchoia_multifasciata	F	F	F
Kottelatia_brittani	F	T	F
Kraemeria_bryani	T	F	F
Kraemeria_cunicularia	T	T	T
Kryptolebias_caudomarginatus	F	T	F
Kryptolebias_marmoratus	F	T	T
Kuhlia_caudavittata	T	T	T
Kuhlia_malo	T	T	T
Kuhlia_marginata	T	T	T
Kuhlia_munda	F	T	T
Kuhlia_nutabunda	T	F	F
Kuhlia_petiti	T	F	F
Kuhlia_rupestris	T	T	T
Kuhlia_salelea	F	T	F
Kuhlia_sandvicensis	T	T	T
Kuhlia_sauvagii	F	T	T
Kuhlia_xenura	T	T	T
Kyphosus_vaigiensis	T	F	T
Labeo_angra	F	T	F
Labeo_bata	F	T	F
Labeo_batesii	F	T	F
Labeo_boga	F	T	F
Labeo_calbasu	F	T	T
Labeo_chrysophekadion	F	T	F
Labeo_cyclorhynchus	F	T	F
Labeo_forskalii	F	T	F
Labeo_horie	F	T	F
Labeo_niloticus	F	T	F
Labeo_parvus	F	T	F
Labeo_rohita	F	T	T
Labeo_senegalensis	F	T	F
Labeo_stolizkae	F	T	F
Labeo_weeksii	F	T	F
Labeo_yunnanensis	F	T	F
Labiobarbus_lineatus	F	T	F
Labiobarbus_ocellatus	F	T	F
Labiobarbus_siamensis	F	T	F
Labrisomus_bucciferus	F	F	F
Labrisomus_guppyi	F	F	F
Labrisomus_haitiensis	T	F	F
Labrisomus_nigricinctus	T	F	F
Labrisomus_striatus	F	F	F
Labrisomus_xanti	T	F	F
Labrus_mixtus	T	F	F
Lactophrys_trigonus	T	F	F
Lactoria_cornuta	T	F	F
Lactoria_diaphana	T	F	F
Lagocephalus_guentheri	T	F	F
Lagocephalus_laevigatus	T	F	T
Lagocephalus_lunaris	T	F	T
Lagocephalus_suezensis	T	F	F
Lagocephalus_wheeleri	T	F	F
Laimosemion_mahdiaensis	F	T	F
Lampris_immaculatus	T	F	F
Lateolabrax_japonicus	T	T	T
Laubuca_caeruleostigmata	F	T	F
Laubuca_fasciata	F	F	F
Laubuca_laubuca	F	F	F
Lavinia_exilicauda	F	T	F
Lefua_costata	F	T	F
Lefua_echigonia	F	T	F
Lentipes_armatus	T	T	T
Lentipes_kaaea	T	T	T
Lepadogaster_lepadogaster	T	F	F
Lepidiolamprologus_attenuatus	F	T	F
Lepidiolamprologus_cunningtoni	F	F	F
Lepidiolamprologus_profundicola	F	T	F
Lepidoblepharon_ophthalmolepis	T	F	F
Lepidogalaxias_salamandroides	F	T	F
Lepidomeda_albivallis	F	T	F
Lepidomeda_vittata	F	T	F
Lepidonectes_corallicola	T	F	F
Lepidonotothen_larseni	F	F	F
Lepidonotothen_nudifrons	F	F	F
Lepidonotothen_squamifrons	T	F	F
Lepidopus_caudatus	T	F	F
Lepidorhombus_boscii	T	F	F
Lepidorhombus_whiffiagonis	T	F	F
Lepidotrigla_cavillone	T	F	T
Lepisosteus_osseus	F	T	T
Lepomis_auritus	F	T	F
Lepomis_cyanellus	F	T	F
Lepomis_gibbosus	F	T	F
Lepomis_gulosus	F	T	F
Lepomis_humilis	F	T	F
Lepomis_macrochirus	F	T	F
Lepomis_marginatus	F	T	F
Lepomis_megalotis	F	T	F
Lepomis_microlophus	F	T	F
Lepomis_miniatus	F	T	F
Lepomis_punctatus	F	T	F
Lepomis_symmetricus	F	T	F
Leptobotia_pellegrini	F	T	F
Leptocypris_niloticus	F	T	F
Lethrinus_olivaceus	T	F	F
Lichia_amia	T	F	T
Limia_dominicensis	F	F	F
Limia_heterandria	F	T	F
Limia_melanogaster	F	F	F
Lindbergichthys_mizops	F	F	F
Liobagrus_anguillicauda	F	T	F
Liopropoma_lunulatum	T	F	F
Liparis_fabricii	T	F	F
Liparis_liparis	T	F	F
Liparis_montagui	T	F	F
Liparis_liparis_liparis	F	F	F
Lithognathus_mormyrus	T	F	T
Liza_haematocheila	F	F	F
Liza_ramada	F	F	F
Liza_saliens	F	F	F
Llanolebias_stellifer	F	T	F
Lobocheilos_melanotaenia	F	F	F
Lophius_budegassa	T	F	T
Lophius_piscatorius	T	F	T
Lophogobius_cyprinoides	T	T	T
Lopholatilus_chamaeleonticeps	T	F	F
Lovettia_sealii	T	T	T
Lucayablennius_zingaro	T	F	F
Lucifuga_dentata	F	T	F
Lucifuga_simile	F	T	T
Lucifuga_subterranea	F	T	F
Luciobrama_macrocephalus	F	T	T
Luciosoma_bleekeri	F	T	F
Lutjanus_analis	T	T	T
Luxilus_chrysocephalus	F	T	F
Lycodes_terraenovae	T	F	F
Lythrypnus_dalli	T	F	F
Lythrypnus_zebra	T	F	F
Macrhybopsis_aestivalis	F	T	F
Macrochirichthys_macrochirus	F	T	F
Mahidolia_mystacina	T	F	T
Makaira_nigricans	T	F	F
Malacoctenus_aurolineatus	T	F	F
Malacoctenus_boehlkei	T	F	F
Malacoctenus_ebisui	T	F	F
Malacoctenus_gigas	T	F	F
Malacoctenus_hubbsi	T	F	F
Malacoctenus_tetranemus	T	F	F
Malacoctenus_triangulatus	T	F	F
Malacoctenus_zacae	T	F	F
Malacoctenus_zonifer	T	F	F
Malacoctenus_zonogaster	T	F	F
Malayochela_maassi	F	T	F
Maratecoara_formosa	F	T	F
Margariscus_margarita	F	T	F
Marilyna_darwinii	T	F	T
Mastacembelus_erythrotaenia	F	T	F
Mccoskerichthys_sandae	T	F	F
Meda_fulgida	F	T	F
Meiacanthus_oualanensis	T	F	F
Mekongina_erythrospila	F	T	F
Melanogrammus_aeglefinus	T	F	F
Melanorivulus_pictus	F	T	F
Melanorivulus_punctatus	F	T	F
Melanorivulus_violaceus	F	T	F
Melichthys_indicus	T	F	F
Melichthys_niger	T	F	F
Melichthys_vidua	T	F	F
Mene_maculata	T	F	F
Menticirrhus_americanus	T	T	T
Merlangius_merlangus	T	F	T
Merluccius_australis	T	F	F
Merluccius_capensis	T	F	F
Merluccius_gayi	T	F	F
Merluccius_hubbsi	T	F	F
Merluccius_paradoxus	T	F	F
Merluccius_polli	T	F	F
Merluccius_productus	T	F	F
Merluccius_senegalensis	T	F	F
Merluccius_gayi_gayi	F	F	F
Mesobola_brevianalis	F	F	F
Mesogobius_batrachocephalus	F	T	T
Metzia_formosae	F	T	F
Metzia_lineata	F	T	T
Meuschenia_trachylepis	T	F	F
Microchirus_azevia	T	F	F
Microchirus_variegatus	T	F	F
Microdesmus_bahianus	T	F	F
Microdesmus_carri	T	F	T
Microdesmus_longipinnis	T	F	F
Microdevario_gatesi	F	T	F
Microgobius_microlepis	T	F	T
Micromesistius_poutassou	T	F	F
Microphysogobio_longidorsalis	F	T	F
Micropoecilia_branneri	F	F	F
Micropterus_cataractae	F	T	F
Micropterus_coosae	F	T	F
Micropterus_dolomieu	F	T	F
Micropterus_floridanus	F	T	F
Micropterus_notius	F	T	F
Micropterus_punctulatus	F	T	F
Micropterus_salmoides	F	T	F
Micropterus_treculii	F	T	F
Microstomus_kitt	T	F	F
Minytrema_melanops	F	T	F
Misgurnus_nikolskyi	F	T	F
Moapa_coriacea	F	T	F
Mola_mola	T	F	T
Molva_dypterygia	T	F	T
Molva_molva	T	F	F
Monacanthus_chinensis	T	F	T
Monacanthus_ciliatus	T	F	F
Monopterus_albus	F	T	T
Monotaxis_grandoculis	T	F	F
Monotrete_cochinchinensis	F	F	F
Monotrete_leiurus	F	F	F
Moolgarda_cunnesius	T	T	T
Mora_moro	T	F	F
Mugil_cephalus	T	T	T
Mullus_barbatus	T	F	T
Mullus_barbatus_barbatus	F	F	F
Muraena_augusti	T	F	F
Muraena_helena	T	F	F
Muraena_melanotis	T	F	F
Muraena_robusta	T	F	F
Mycteroperca_fusca	T	F	F
Mycteroperca_rubra	T	F	F
Mylocheilus_caurinus	F	T	T
Mylopharodon_conocephalus	F	T	F
Myoxocephalus_quadricornis	T	T	T
Myoxocephalus_scorpius	T	F	T
Myripristis_berndti	T	F	F
Myripristis_violacea	T	F	F
Mystacoleucus_marginatus	F	F	F
Myxocyprinus_asiaticus	F	T	F
Nannosalarias_nativitatis	T	F	F
Naso_brevirostris	T	F	F
Naso_elegans	T	F	F
Naso_unicornis	T	F	F
Naso_vlamingii	T	F	F
Nemateleotris_magnifica	T	F	F
Nematolebias_whitei	F	T	F
Neobola_bottegoi	F	T	F
Neochanna_burrowsius	F	T	F
Neoclinus_blanchardi	T	F	F
Neocyttus_helgae	T	F	F
Neocyttus_rhomboidalis	T	F	F
Neofundulus_paraguayensis	F	T	F
Neolamprologus_furcifer	F	T	F
Neolamprologus_mondabu	F	T	F
Neolamprologus_tretocephalus	F	T	F
Neomerinthe_hemingwayi	T	F	F
Neoniphon_argenteus	T	F	F
Neoniphon_aurolineatus	T	F	F
Neoniphon_sammara	T	F	F
Neosalanx_anderssoni	T	T	T
Nes_longus	T	F	F
Nicholsicypris_normalis	F	F	F
Nipponocypris_sieboldii	F	T	F
Nipponocypris_temminckii	F	T	F
Niwaella_delicata	F	F	F
Nocomis_asper	F	T	F
Nocomis_biguttatus	F	T	F
Nocomis_effusus	F	T	F
Nocomis_leptocephalus	F	T	F
Nocomis_micropogon	F	T	F
Nocomis_raneyi	F	T	F
Notemigonus_crysoleucas	F	T	F
Nothobranchius_orthonotus	F	T	F
Notolepis_coatsi	T	F	F
Notothenia_angustata	T	F	F
Notothenia_coriiceps	T	F	F
Notothenia_neglecta	T	F	F
Notropis_atherinoides	F	T	F
Notropis_baileyi	F	T	F
Notropis_blennius	F	T	F
Notropis_boucardi	F	T	F
Notropis_calientis	F	T	F
Notropis_chiliticus	F	T	F
Notropis_chlorocephalus	F	T	F
Notropis_chrosomus	F	T	F
Notropis_imeldae	F	T	F
Notropis_leuciodus	F	T	F
Notropis_longirostris	F	T	F
Notropis_lutipinnis	F	T	F
Notropis_moralesi	F	T	F
Notropis_nubilus	F	T	F
Notropis_petersoni	F	T	F
Notropis_rubellus	F	T	F
Notropis_rubricroceus	F	T	F
Notropis_spectrunculus	F	T	F
Notropis_texanus	F	T	F
Notropis_volucellus	F	T	F
Oblada_melanura	T	F	T
Ochetobius_elongatus	F	T	F
Odontanthias_chrysostictus	T	F	F
Odonus_niger	T	F	F
Omegophora_armilla	T	F	F
Omobranchus_anolius	T	F	T
Omobranchus_obliquus	T	F	T
Oncorhynchus_clarkii	T	T	T
Onigocia_bimaculata	T	F	F
Onychostoma_barbatulum	F	T	F
Onychostoma_ovale	F	T	F
Ophioblennius_macclurei	T	F	F
Ophioblennius_steindachneri	T	F	F
Ophiogobius_jenynsi	T	F	T
Ophisurus_macrorhynchos	T	F	F
Ophthalmolebias_bokermanni	F	T	F
Ophthalmolebias_constanciae	F	T	F
Oplopomus_oplopomus	T	F	F
Opsanus_pardus	T	F	F
Opsaridium_boweni	F	T	F
Opsaridium_peringueyi	F	T	F
Opsaridium_ubangiense	F	T	F
Opsariichthys_evolans	F	T	F
Opsariichthys_pachycephalus	F	T	F
Opsariichthys_uncirostris	F	T	F
Opsarius_bakeri	F	F	F
Opsarius_koratensis	F	T	F
Opsarius_pulchellus	F	T	F
Opsopoeodus_emiliae	F	T	F
Opsopoeodus_emiliae_emiliae	F	F	F
Oregonichthys_crameri	F	T	F
Oreichthys_cosuatis	F	T	F
Oreoglanis_macropterus	F	F	F
Orthodon_microlepidotus	F	T	T
Osmerus_mordax	T	T	T
Osmerus_mordax_dentex	F	F	F
Osmerus_mordax_mordax	F	F	F
Osteochilus_lini	F	T	F
Osteochilus_melanopleurus	F	F	F
Osteochilus_microcephalus	F	T	F
Osteochilus_nashii	F	F	F
Osteochilus_salsburyi	F	T	F
Osteochilus_vittatus	F	T	F
Osteochilus_waandersii	F	T	F
Ostorhinchus_fasciatus	T	F	F
Ostracion_cubicus	T	F	F
Ostracion_meleagris	T	F	F
Ostracion_rhinorhynchos	T	F	F
Ostracion_solorensis	T	F	F
Ostracion_whitleyi	T	F	F
Oxygaster_anomalura	F	T	F
Oxymonacanthus_longirostris	T	F	F
Pachypanchax_omalonotus	F	T	F
Pachypanchax_playfairii	F	T	T
Pachypanchax_sakaramyi	F	T	F
Pagellus_acarne	T	F	F
Pagellus_bellottii	T	F	F
Pagellus_bogaraveo	T	F	T
Pagellus_erythrinus	T	F	T
Pagetopsis_maculatus	T	F	F
Pagothenia_borchgrevinki	T	F	F
Pagrus_auriga	T	F	F
Pagrus_caeruleostictus	T	F	T
Pagrus_pagrus	T	F	T
Pamphorichthys_araguaiensis	F	T	F
Pamphorichthys_hasemani	F	T	F
Pamphorichthys_hollandi	F	T	F
Pamphorichthys_scalpridens	F	T	F
Pampus_argenteus	T	F	F
Pangasianodon_hypophthalmus	F	T	F
Pangio_oblonga	F	T	F
Parablennius_marmoreus	T	F	F
Parabotia_banarescui	F	T	F
Parabotia_bimaculata	F	T	F
Parabotia_lijiangensis	F	T	F
Parabotia_mantschurica	F	F	F
Paracanthurus_hepatus	T	F	F
Parachaenichthys_charcoti	T	F	F
Parachaenichthys_georgianus	T	F	F
Paracheirodon_innesi	F	T	F
Parachela_maculicauda	F	T	F
Parachela_oxygastroides	F	T	F
Parachela_siamensis	F	T	F
Parachela_williaminae	F	T	F
Paracirrhites_forsteri	T	F	F
Paracirrhites_hemistictus	T	F	F
Paraclinus_integripinnis	T	F	F
Paraclinus_marmoratus	T	F	F
Paraclinus_mexicanus	T	F	F
Paraclinus_sini	T	F	F
Paracrossochilus_vittatus	F	T	F
Paradiplospinus_antarcticus	T	F	F
Paragobiodon_modestus	T	F	F
Parahollardia_lineata	T	F	F
Paralaubuca_typus	F	T	F
Paraluteres_prionurus	T	F	F
Parambassis_ranga	F	T	T
Parambassis_wolffii	F	T	F
Paramonacanthus_choirocephalus	T	F	F
Paramonacanthus_filicauda	F	F	F
Paranotothenia_magellanica	T	F	F
Parapercis_clathrata	T	F	F
Parapristipoma_octolineatum	T	F	F
Parasinilabeo_assimilis	F	T	F
Parastromateus_niger	T	F	T
Pareuchiloglanis_gracilicaudata	F	T	F
Patagonotothen_guntheri	T	F	F
Patagonotothen_ramsayi	T	F	F
Patagonotothen_tessellata	T	F	F
Pavoclinus_graminis	T	F	F
Pavoclinus_profundus	T	F	F
Pectenocypris_korthausae	F	T	F
Pegusa_cadenati	T	F	F
Pelagocephalus_marki	T	F	F
Pelasgus_prespensis	F	T	F
Pelecus_cultratus	F	T	T
Pempheris_schwenkii	T	F	F
Pentanemus_quinquarius	T	F	T
Perca_fluviatilis	F	T	T
Percopsis_transmontana	F	T	F
Pervagor_janthinosoma	T	F	F
Pervagor_melanocephalus	T	F	F
Pervagor_nigrolineatus	T	F	F
Pethia_conchonius	F	T	F
Pethia_erythromycter	F	T	F
Pethia_gelius	F	T	F
Pethia_manipurensis	F	T	F
Pethia_nigrofasciata	F	T	F
Pethia_padamya	F	T	F
Pethia_phutunio	F	T	F
Pethia_shalynius	F	T	F
Pethia_stoliczkana	F	T	T
Pethia_tiantian	F	T	F
Pethia_ticto	F	T	F
Petroscirtes_mitratus	T	F	F
Phenacobius_catostomus	F	T	F
Phenacogrammus_interruptus	F	T	F
Pholis_gunnellus	T	F	F
Phoxinellus_alepidotus	F	T	F
Phoxinellus_dalmaticus	F	T	F
Phoxinellus_pseudalepidotus	F	T	F
Phoxinus_keumkang	F	F	F
Phoxinus_phoxinus	F	T	F
Phreatichthys_andruzzii	F	T	F
Phrynorhombus_norvegicus	F	F	F
Pituna_poranga	F	T	F
Placocheilus_cryptonemus	F	T	F
Plagiotremus_azaleus	T	F	F
Plagiotremus_rhinorhynchos	T	F	F
Plagiotremus_tapeinosoma	T	F	F
Plagopterus_argentissimus	F	T	F
Platichthys_flesus	T	T	T
Platygillellus_rubrocinctus	T	F	F
Platygobio_gracilis	F	T	F
Plecodus_multidentatus	F	T	F
Plecoglossus_altivelis	T	T	T
Plecoglossus_altivelis_altivelis	F	F	F
Plectorhinchus_mediterraneus	T	F	F
Pleuragramma_antarctica	T	F	F
Pleuronectes_platessa	T	T	T
Poecilia_caucana	F	T	F
Poecilia_latipunctata	F	T	F
Poecilia_vivipara	F	T	T
Pogonichthys_macrolepidotus	F	T	T
Pogonophryne_scotti	T	F	F
Pollachius_pollachius	T	F	F
Pollachius_virens	T	F	F
Polymixia_nobilis	T	F	F
Polyodon_spathula	F	T	F
Polyprion_americanus	T	F	T
Polyspina_piosae	T	F	F
Pomadasys_incisus	T	F	F
Pomadasys_perotaei	T	F	T
Pomatomus_saltatrix	T	F	T
Pomoxis_annularis	F	T	F
Pomoxis_nigromaculatus	F	T	F
Ponticola_cephalargoides	T	F	T
Pontinus_kuhlii	T	F	F
Praealticus_caesius	T	F	F
Praealticus_labrovittatus	T	F	F
Praealticus_margaritatus	T	F	F
Praealticus_striatus	T	F	F
Praealticus_tanegasimae	T	F	F
Priacanthus_hamrur	T	F	F
Priolepis_cincta	T	F	T
Priolepis_eugenius	T	F	F
Priolepis_hipoliti	T	F	F
Prionodraco_evansii	T	F	F
Prionurus_biafraensis	T	F	F
Prionurus_laticlavius	T	F	F
Prionurus_maculatus	T	F	F
Protemblemaria_bicirrus	T	F	F
Proterorhinus_semilunaris	F	T	T
Protogobius_attiti	T	T	T
Protosalanx_chinensis	T	T	T
Prototroctes_maraena	T	T	T
Psammogobius_biocellatus	T	T	T
Psenopsis_anomala	T	F	F
Pseudaphritis_urvillii	T	T	T
Pseudaspius_leptocephalus	F	T	T
Pseudecheneis_sulcata	F	T	F
Pseudexostoma_yunnanense	F	T	F
Pseudobagrus_tokiensis	F	T	F
Pseudobalistes_flavimarginatus	T	F	T
Pseudobalistes_fuscus	T	F	F
Pseudobalistes_naufragium	T	F	F
Pseudocaranx_dentex	T	F	T
Pseudochaenichthys_georgianus	T	F	F
Pseudocrossocheilus_bamaensis	F	T	F
Pseudocrossocheilus_liuchengensis	F	T	F
Pseudocrossocheilus_longibullus	F	T	F
Pseudocrossocheilus_nigrovittatus	F	T	F
Pseudocrossocheilus_papillolabrus	F	T	F
Pseudocrossocheilus_tridentis	F	T	F
Pseudogastromyzon_changtingensis	F	T	F
Pseudogastromyzon_cheni	F	T	F
Pseudogastromyzon_fangi	F	T	F
Pseudogastromyzon_changtingensis_tungpeiensis	F	F	F
Pseudogyrinocheilus_prochilus	F	T	F
Pseudomonacanthus_macrurus	T	F	F
Pseudomonacanthus_peroni	T	F	F
Pseudorasbora_parva	F	T	T
Pseudorasbora_pumila	F	T	F
Pseudotolithus_elongatus	T	T	T
Pseudotolithus_senegalensis	T	F	T
Pseudotolithus_senegallus	T	T	T
Pseudotolithus_typus	T	T	T
Pseudotriacanthus_strigilifer	T	F	F
Psilodraco_breviceps	T	F	F
Ptereleotris_microlepis	T	F	F
Ptereleotris_monoptera	T	F	F
Pterois_antennata	T	F	F
Pterolebias_longipinnis	F	T	F
Pteronotropis_hypselopterus	F	T	F
Ptychidio_jordani	F	T	F
Ptychocheilus_grandis	F	T	F
Ptychocheilus_lucius	F	T	F
Ptychocheilus_oregonensis	F	T	F
Ptychocheilus_umpquae	F	T	F
Puntius_bimaculatus	F	T	F
Puntius_chalakkudiensis	F	T	F
Puntius_denisonii	F	F	F
Puntius_dunckeri	F	F	F
Puntius_everetti	F	F	F
Puntius_johorensis	F	F	F
Puntius_lateristriga	F	F	F
Puntius_lineatus	F	F	F
Puntius_oligolepis	F	F	F
Puntius_semifasciolatus	F	F	F
Puntius_sophore	F	T	T
Puntius_vittatus	F	T	T
Qianlabeo_striatus	F	T	F
Racovitzia_glacialis	T	F	F
Raiamas_batesii	F	T	F
Raiamas_bola	F	T	F
Raiamas_christyi	F	T	F
Raiamas_guttatus	F	T	F
Raiamas_salmolucius	F	T	F
Raiamas_senegalensis	F	T	F
Ranzania_laevis	T	F	F
Rasbora_argyrotaenia	F	T	F
Rasbora_aurotaenia	F	T	F
Rasbora_borapetensis	F	T	F
Rasbora_cephalotaenia	F	T	F
Rasbora_daniconius	F	T	T
Rasbora_dusonensis	F	T	F
Rasbora_einthovenii	F	T	F
Rasbora_elegans	F	T	F
Rasbora_hobelmani	F	T	F
Rasbora_jacobsoni	F	T	F
Rasbora_kalochroma	F	T	F
Rasbora_kottelati	F	T	F
Rasbora_meinkeni	F	T	F
Rasbora_paviana	F	T	F
Rasbora_rubrodorsalis	F	T	F
Rasbora_steineri	F	T	F
Rasbora_sumatrana	F	T	F
Rasbora_trilineata	F	T	F
Rasbora_tubbi	F	T	F
Rasbora_vulgaris	F	T	F
Rasboroides_vaterifloris	F	T	F
Rasbosoma_spilocerca	F	T	F
Rastrineobola_argentea	F	T	F
Rectoris_posehensis	F	T	F
Regalecus_glesne	T	F	F
Reicheltia_halsteadi	T	F	F
Reinhardtius_hippoglossoides	T	F	F
Relictus_solitarius	F	T	F
Renova_oscari	F	T	F
Rhabdoblennius_nitidus	T	F	F
Rhinecanthus_aculeatus	T	F	F
Rhinecanthus_assasi	T	F	F
Rhinecanthus_lunula	T	F	F
Rhinecanthus_rectangulus	T	F	F
Rhinecanthus_verrucosus	T	F	F
Rhinesomus_triqueter	F	F	F
Rhinichthys_atratulus	F	T	F
Rhinichthys_cataractae	F	T	F
Rhinichthys_cobitis	F	F	F
Rhinichthys_osculus	F	T	F
Rhinogobiops_nicholsii	T	F	F
Rhodeus_ocellatus	F	T	F
Rhyacichthys_guilberti	F	T	F
Rhynchocypris_lagowskii	F	T	F
Rhynchocypris_percnurus	F	T	F
Rhynchopelates_oxyrhynchus	T	F	F
Rhynchostracion_nasus	F	F	F
Richardsonius_balteatus	F	T	F
Richardsonius_egregius	F	T	F
Risor_ruber	T	F	F
Rivulus_cylindraceus	F	T	F
Rivulus_roloffi	F	T	F
Romanogobio_ciscaucasicus	F	T	F
Ruanoho_whero	T	F	F
Rudarius_ercodes	T	F	F
Rutilus_rutilus	F	T	T
Ruvettus_pretiosus	T	F	F
Rypticus_saponaceus	T	F	F
Salangichthys_microdon	T	F	T
Salarias_alboguttatus	T	F	F
Salarias_fasciatus	T	F	F
Salmo_salar	T	T	T
Salmo_trutta	T	T	T
Salmophasia_bacaila	F	F	F
Salmophasia_phulo	F	F	F
Sarcocheilichthys_nigripinnis	F	T	F
Sarcocheilichthys_parvus	F	T	F
Sarcocheilichthys_variegatus	F	T	F
Sarcocheilichthys_nigripinnis_nigripinnis	F	F	F
Sarcocheilichthys_variegatus_microoculus	F	F	F
Sarda_sarda	T	F	T
Sardina_pilchardus	T	T	T
Sardinella_maderensis	T	F	T
Sargocentron_diadema	T	F	F
Sargocentron_microstoma	T	F	F
Sargocentron_punctatissimum	T	F	F
Sargocentron_spiniferum	T	F	F
Sargocentron_tiere	T	F	F
Sargocentron_xantherythrum	T	F	F
Sarotherodon_galilaeus	F	T	T
Sarpa_salpa	T	F	F
Sawbwa_resplendens	F	T	F
Scardinius_erythrophthalmus	F	T	T
Scarus_psittacus	T	F	F
Scatophagus_argus	T	T	T
Schedophilus_ovalis	T	F	F
Schedophilus_velaini	T	F	F
Schismatorhynchos_nukta	F	F	F
Schistura_balteata	F	T	F
Scomber_colias	T	F	T
Scomber_japonicus	T	F	F
Scomber_scombrus	T	F	F
Scomberomorus_brasiliensis	T	F	F
Scomberomorus_cavalla	T	F	F
Scomberomorus_commerson	T	F	F
Scomberomorus_maculatus	T	F	F
Scomberomorus_regalis	T	F	F
Scophthalmus_maximus	T	F	T
Scorpaena_elongata	T	F	F
Scorpaena_maderensis	T	F	T
Scorpaena_notata	T	F	T
Scorpaena_onaria	T	F	F
Scorpaena_porcus	T	F	T
Scorpaena_scrofa	T	F	T
Scorpaenodes_guamensis	T	F	T
Scorpaenodes_minor	T	F	F
Scorpaenopsis_diabolus	T	F	F
Scorpaenopsis_macrochir	T	F	T
Scorpaenopsis_possi	T	F	F
Scriptaphyosemion_banforense	F	T	F
Scriptaphyosemion_guignardi	F	T	F
Sebastes_schlegelii	T	F	F
Sebastes_viviparus	T	F	F
Securicula_gora	F	T	F
Selar_crumenophthalmus	T	F	F
Semilabeo_notabilis	F	T	F
Semilabeo_obscurus	F	T	F
Semotilus_atromaculatus	F	T	F
Seriola_carpenteri	T	F	F
Seriola_dumerili	T	F	F
Seriola_fasciata	T	F	F
Seriola_rivoliana	T	F	F
Serranus_accraensis	T	F	F
Serranus_atricauda	T	F	F
Serranus_cabrilla	T	F	F
Serranus_hepatus	T	F	F
Serranus_scriba	T	T	T
Sicydium_plumieri	T	T	T
Sicydium_punctatum	T	T	T
Sicyopterus_lagocephalus	T	T	T
Sicyopterus_pugnans	T	T	T
Sicyopus_zosterophorus	T	T	T
Signigobius_biocellatus	T	F	F
Silurus_meridionalis	F	T	F
Sinibotia_robusta	F	T	F
Sinibotia_superciliaris	F	T	F
Sinocrossocheilus_megalophthalmus	F	T	F
Sinocyclocheilus_anophthalmus	F	T	F
Sinocyclocheilus_furcodorsalis	F	T	F
Sinocyclocheilus_macrophthalmus	F	T	F
Sinocyclocheilus_microphthalmus	F	T	F
Sinocyclocheilus_qiubeiensis	F	T	F
Sinocyclocheilus_yangzongensis	F	T	T
Siphateles_alvordensis	F	T	F
Siphateles_bicolor	F	T	F
Siphateles_boraxobius	F	T	F
Smilosicyopus_chloe	T	T	T
Smilosicyopus_sasali	T	T	T
Snyderichthys_copei	F	F	F
Solea_aegyptiaca	T	F	T
Solea_senegalensis	T	F	F
Sparisoma_cretense	T	F	F
Sparisoma_rubripinne	T	F	F
Sparus_aurata	T	F	T
Speoplatyrhinus_poulsoni	F	T	F
Sphoeroides_annulatus	T	T	T
Sphoeroides_cheesemanii	F	F	F
Sphoeroides_dorsalis	T	F	F
Sphoeroides_lispus	T	F	F
Sphoeroides_lobatus	T	F	T
Sphoeroides_maculatus	T	F	T
Sphoeroides_nephelus	T	F	T
Sphoeroides_pachygaster	T	F	F
Sphoeroides_parvus	T	F	T
Sphoeroides_spengleri	T	F	T
Sphoeroides_testudineus	T	T	T
Sphyraena_barracuda	T	F	T
Sphyraena_guachancho	T	F	F
Sphyraena_viridensis	T	F	F
Spicara_maena	T	F	F
Spicara_smaris	T	F	T
Spinachia_spinachia	T	F	T
Spinibarbus_denticulatus	F	F	F
Spinibarbus_sinensis	F	T	F
Spondyliosoma_cantharus	T	F	T
Sprattus_sprattus	T	T	T
Squaliobarbus_curriculus	F	T	F
Squalius_aradensis	F	T	F
Squalius_carolitertii	F	T	F
Squalius_cephalus	F	T	T
Squalius_pyrenaicus	F	T	F
Squalius_torgalensis	F	T	F
Starksia_atlantica	T	F	F
Starksia_fasciata	T	F	F
Starksia_galapagensis	T	F	F
Starksia_grammilaga	T	F	F
Starksia_lepicoelia	T	F	F
Starksia_nanodes	T	F	F
Starksia_ocellata	T	F	F
Starksia_posthon	T	F	F
Starksia_spinipenis	T	F	F
Stathmonotus_culebrai	T	F	F
Stathmonotus_lugubris	T	F	F
Stathmonotus_stahli	T	F	F
Stephanolepis_auratus	T	F	F
Stephanolepis_cirrhifer	T	F	F
Stephanolepis_hispidus	T	F	F
Stereolepis_gigas	T	F	F
Stigmatopora_nigra	T	F	T
Stiphodon_atratus	T	T	T
Stiphodon_elegans	T	T	T
Stiphodon_hydoreibatus	T	T	T
Stiphodon_rubromaculatus	T	T	T
Stiphodon_rutilaureus	T	T	T
Stiphodon_sapphirinus	T	T	T
Stokellia_anisodon	T	T	T
Stomias_gracilis	T	F	F
Stonogobiops_xanthorhinica	T	F	F
Sufflamen_albicaudatum	T	F	F
Sufflamen_bursa	T	F	F
Sufflamen_chrysopterum	T	F	F
Sufflamen_fraenatum	T	F	F
Sufflamen_verres	T	F	F
Syacium_micrurum	T	F	F
Synagrops_bellus	T	F	F
Synaptura_lusitanica	T	F	T
Synaptura_lusitanica_lusitanica	F	F	F
Synapturichthys_kleinii	T	F	T
Syngnathus_acus	T	F	T
Syngnathus_typhle	T	T	T
Synodus_saurus	T	F	F
Systomus_foerschi	F	F	F
Systomus_orphoides	F	T	F
Systomus_pentazona	F	F	F
Systomus_rhomboocellatus	F	F	F
Systomus_tetrazona	F	F	F
Takifugu_niphobles	T	F	F
Takifugu_ocellatus	F	T	T
Takifugu_pardalis	T	F	F
Takifugu_poecilonotus	F	F	F
Takifugu_porphyreus	T	F	T
Takifugu_rubripes	T	F	T
Takifugu_stictonotus	T	F	F
Takifugu_xanthopterus	T	F	T
Talismania_longifilis	T	F	F
Tampichthys_catostomops	F	T	F
Tampichthys_dichromus	F	F	F
Tampichthys_erimyzonops	F	T	F
Tampichthys_ipni	F	T	F
Tampichthys_mandibularis	F	T	F
Tanakia_himantegus	F	T	F
Tanakia_limbata	F	T	F
Tanichthys_micagemmae	F	T	F
Taractichthys_longipinnis	T	F	F
Taurulus_bubalis	T	F	T
Telestes_croaticus	F	T	F
Telestes_fontinalis	F	T	F
Telestes_metohiensis	F	T	F
Telestes_souffia	F	T	F
Terranatos_dolichopterus	F	T	F
Tetractenos_glaber	T	T	T
Tetractenos_hamiltoni	T	F	F
Tetraodon_biocellatus	F	F	F
Tetraodon_cambodgiensis	F	F	F
Tetraodon_duboisi	F	T	F
Tetraodon_erythrotaenia	T	T	T
Tetraodon_fluviatilis	F	F	F
Tetraodon_lineatus	F	T	T
Tetraodon_mbu	F	T	T
Tetraodon_miurus	F	T	F
Tetraodon_nigroviridis	F	F	F
Tetraodon_palembangensis	F	T	F
Tetraodon_pustulatus	F	T	T
Tetraodon_suvattii	F	T	F
Tetrapturus_angustirostris	T	F	F
Tetrapturus_belone	T	F	F
Tetrapturus_georgii	T	F	F
Tetrapturus_pfluegeri	T	F	F
Tetrosomus_concatenatus	T	F	F
Tetrosomus_fornasini	F	F	F
Tetrosomus_gibbosus	T	F	F
Tetrosomus_reipublicae	T	F	F
Thalassoma_pavo	T	T	F
Thamnaconus_modestus	T	F	T
Thunnus_alalunga	T	F	F
Thunnus_albacares	T	F	F
Thunnus_atlanticus	T	F	F
Thunnus_obesus	T	F	F
Thunnus_orientalis	T	F	F
Thunnus_thynnus	T	F	F
Thynnichthys_thynnoides	F	T	F
Tigrigobius_gemmatus	T	F	F
Tigrigobius_inornatus	F	F	F
Tigrigobius_janssi	T	F	F
Tigrigobius_macrodon	T	F	F
Tigrigobius_multifasciatus	T	F	F
Tigrigobius_nesiotes	T	F	F
Tigrigobius_saucrus	T	F	F
Tinca_tinca	F	T	T
Tomicodon_humeralis	T	F	F
Tomicodon_myersi	T	F	F
Tomiyamichthys_lanceolatus	T	F	F
Tor_sinensis	F	T	F
Torquigener_altipinnis	T	F	T
Torquigener_flavimaculosus	T	F	F
Torquigener_hypselogeneion	T	F	T
Torquigener_pleurogramma	T	F	T
Torquigener_squamicauda	T	F	T
Toxotes_chatareus	F	T	T
Traccatichthys_pulcher	F	T	F
Trachinotus_ovatus	T	F	T
Trachinus_draco	T	F	F
Trachinus_radiatus	T	F	F
Trachurus_mediterraneus	T	F	T
Trachurus_picturatus	T	F	F
Trachyrincus_murrayi	T	F	F
Trematomus_eulepidotus	T	F	F
Trematomus_hansoni	T	F	F
Trematomus_lepidorhinus	F	F	F
Trematomus_loennbergii	T	F	F
Trematomus_newnesi	T	F	F
Trematomus_nicolai	F	F	F
Trematomus_pennellii	T	F	F
Trematomus_scotti	F	F	F
Trematomus_tokarevi	T	F	F
Trematomus_vicarius	F	F	F
Triacanthodes_ethiops	T	F	F
Triacanthus_nieuhofii	T	F	F
Tribolodon_brandtii	F	F	F
Tribolodon_hakonensis	F	F	F
Tribolodon_nakamurai	F	T	F
Tribolodon_sachalinensis	F	F	F
Trichiurus_lepturus	T	F	T
Trigla_lyra	T	F	T
Trigloporus_lastoviza	F	F	F
Trigonectes_balzanii	F	T	F
Trigonectes_rubromarginatus	F	T	F
Trigonopoma_gracile	F	T	F
Trigonopoma_pauciperforatum	F	T	F
Trigonostigma_hengeli	F	T	F
Trimma_caesiura	T	F	F
Trimma_flammeum	T	F	F
Trimmatom_eviotops	T	F	F
Triodon_macropterus	T	F	F
Triplophysa_rosa	F	T	F
Trisopterus_esmarkii	T	F	F
Trisopterus_luscus	T	F	T
Trisopterus_minutus	T	F	F
Trixiphichthys_weberi	T	F	F
Tropidophoxinellus_alburnoides	F	F	F
Tydemania_navigatoris	T	F	F
Tylosurus_acus	T	F	F
Tylosurus_acus_acus	F	F	F
Typhlichthys_subterraneus	F	T	F
Umbra_pygmaea	F	T	F
Umbrina_canariensis	T	F	F
Uranoscopus_albesca	T	F	F
Uranoscopus_scaber	T	F	T
Vaillantella_maassi	F	T	F
Valenciennea_longipinnis	T	F	F
Valenciennea_puellaris	T	F	F
Vanacampus_margaritifer	T	F	F
Vanderhorstia_ornatissima	T	F	F
Vanmanenia_caldwelli	F	T	F
Vanmanenia_pingchowensis	F	T	F
Vomeridens_infuscipinnis	T	F	F
Xanthichthys_auromarginatus	T	F	F
Xanthichthys_lineopunctatus	T	F	F
Xanthichthys_mento	T	F	F
Xanthichthys_ringens	T	F	F
Xenocypris_macrolepis	F	T	F
Xenomedea_rhodopyga	T	F	F
Xiphophorus_malinche	F	T	F
Yuriria_alta	F	T	F
Zacco_platypus	F	T	F
Zebrasoma_desjardinii	T	F	F
Zebrasoma_flavescens	T	F	F
Zebrasoma_scopas	T	F	F
Zebrasoma_velifer	T	F	F
Zenopsis_conchifer	T	F	F
Zosterisessor_ophiocephalus	F	F	F
Abbottina_rivularis	F	T	F
Abramis_brama	F	T	T
Abudefduf_sexfasciatus	T	F	F
Acanthochromis_polyacanthus	T	F	F
Acanthopagrus_berda	T	T	T
Acanthopagrus_butcheri	T	F	T
Acanthopagrus_schlegelii	T	F	T
Acarichthys_heckelii	F	T	F
Acaronia_nassa	F	T	F
Acaronia_vultuosa	F	T	F
Acropoma_japonicum	T	F	F
Acrossocheilus_paradoxus	F	T	F
Acyrtops_beryllinus	T	F	F
Aeoliscus_strigatus	T	F	F
Aequidens_diadema	F	T	F
Aequidens_michaeli	F	T	F
Aequidens_tetramerus	F	T	F
Ageneiosus_ucayalensis	F	T	F
Agonopsis_chiloensis	T	F	F
Alabes_scotti	T	F	F
Albula_glossodonta	T	F	T
Albula_koreana	T	F	F
Aldrovandia_affinis	T	F	F
Alepocephalus_agassizii	T	F	F
Alepocephalus_antipodianus	T	F	F
Alepocephalus_bairdii	T	F	F
Alepocephalus_bicolor	T	F	F
Alloclinus_holderi	T	F	F
Altolamprologus_calvus	F	T	F
Altolamprologus_compressiceps	F	T	F
Amatitlania_myrnae	F	T	F
Amatitlania_sajica	F	T	F
Amatitlania_siquia	F	T	F
Amazonsprattus_scintilla	F	T	F
Amblyglyphidodon_curacao	T	F	F
Amblyglyphidodon_leucogaster	T	F	F
Ameiurus_nebulosus	F	T	F
Amphilophus_astorquii	F	T	F
Amphilophus_citrinellus	F	T	F
Amphilophus_labiatus	F	T	F
Amphilophus_lyonsi	F	T	F
Amphilophus_macracanthus	F	F	F
Amphilophus_sagittae	F	T	F
Amphilophus_xiloaensis	F	T	F
Amphilophus_zaliosus	F	T	F
Amphiprion_akindynos	T	F	F
Amphiprion_clarkii	T	F	F
Anableps_anableps	F	T	T
Anarhichas_lupus	T	F	F
Anchoa_cayorum	T	F	F
Anchoa_colonensis	T	F	T
Anchoa_cubana	T	F	F
Anchoa_delicatissima	T	F	T
Anchoa_filifera	T	F	T
Anchoa_spinifer	T	T	T
Anchoa_walkeri	T	F	T
Anchovia_clupeoides	T	F	T
Anchovia_surinamensis	F	T	T
Anchoviella_alleni	F	T	F
Anchoviella_balboae	T	F	F
Anchoviella_brevirostris	T	F	T
Anchoviella_carrikeri	F	T	F
Anchoviella_elongata	T	F	T
Anchoviella_guianensis	F	T	T
Anchoviella_lepidentostole	T	T	T
Anchoviella_manamensis	F	T	F
Andinoacara_rivulatus	F	T	F
Anoplogaster_cornuta	T	F	F
Antennarius_striatus	T	F	F
Antigonia_capros	T	F	F
Aphanopus_carbo	T	F	F
Apistogramma_agassizii	F	T	F
Apistogramma_cacatuoides	F	T	F
Apistogramma_hoignei	F	T	F
Apistogramma_panduro	F	T	F
Apistogramma_steindachneri	F	T	F
Apletodon_dentatus	T	F	T
Aplodactylus_punctatus	T	F	F
Apsilus_fuscus	T	F	F
Apterichtus_klazingai	T	F	F
Apteronotus_albifrons	F	T	F
Apteronotus_leptorhynchus	F	T	F
Arapaima_gigas	F	T	F
Archocentrus_centrarchus	F	T	F
Archocentrus_multispinosus	F	F	F
Argentina_sialis	T	F	F
Argyropelecus_aculeatus	T	F	F
Argyropelecus_gigas	T	F	F
Argyrosomus_regius	T	F	T
Ariopsis_felis	T	T	T
Ariosoma_major	F	F	F
Aristostomias_scintillans	T	F	F
Aristostomias_tittmanni	T	F	F
Arnoglossus_laterna	T	F	F
Arripis_trutta	T	F	T
Aspasma_minima	T	F	F
Assessor_flavissimus	T	F	F
Astatotilapia_calliptera	F	T	F
Astronesthes_chrysophekadion	T	F	F
Astronesthes_gemmifer	T	F	F
Astronesthes_macropogon	T	F	F
Astronotus_ocellatus	F	T	F
Astyanax_bimaculatus	F	T	F
Astyanax_mexicanus	F	T	F
Ateleopus_japonicus	T	F	F
Atractosteus_tropicus	F	T	T
Aulonocara_baenschi	F	T	F
Aulonocara_hueseri	F	T	F
Aulonocara_stuartgranti	F	T	F
Aulonocranus_dewindti	F	T	F
Aurigequula_fasciata	T	F	T
Australoheros_facetus	F	T	F
Australoheros_scitulus	F	T	F
Baileychromis_centropomoides	F	T	F
Balistes_capriscus	T	F	F
Barbatula_barbatula	F	T	T
Barbonymus_gonionotus	F	T	F
Barilius_bendelisis	F	T	F
Bassozetus_compressus	T	F	F
Bathophilus_pawneei	T	F	F
Bathophilus_vaillanti	T	F	F
Bathybates_fasciatus	F	T	F
Bathybates_graueri	F	T	F
Bathycongrus_retrotinctus	T	F	F
Bathysaurus_ferox	T	F	F
Bathysaurus_mollis	T	F	F
Bathytroctes_microlepis	T	F	F
Bathyuroconger_parvibranchialis	T	F	F
Belligobio_nummifer	F	T	F
Benthochromis_horii	F	T	F
Benthochromis_melanoides	F	T	F
Benthochromis_tricoti	F	T	F
Benthosema_pterotum	T	F	F
Benthosema_suborbitale	T	F	F
Biotodoma_cupido	F	T	F
Biotodoma_wavrini	F	T	F
Biotoecus_dicentrarchus	F	T	F
Biwia_springeri	F	T	F
Blennophis_anguillaris	T	F	F
Bodianus_mesothorax	T	F	F
Bolinichthys_indicus	T	F	F
Bonapartia_pedaliota	T	F	F
Boraras_merah	F	T	F
Borostomias_antarcticus	T	F	F
Borostomias_panamensis	T	F	F
Boulengerochromis_microlepis	F	T	F
Brachyhypopomus_gauderio	F	T	F
Brachypleura_novaezeelandiae	T	F	F
Brachysomophis_henshawi	T	F	F
Brycinus_macrolepidotus	F	T	F
Bujurquina_apoparuana	F	T	F
Bujurquina_hophrys	F	T	F
Cabdio_morar	F	T	F
Callanthias_ruber	T	F	F
Callionymus_schaapii	T	F	F
Callochromis_macrops	F	T	F
Callorhinchus_milii	T	F	F
Cancelloxus_longior	T	F	F
Canthophrys_gongota	F	T	F
Caquetaia_kraussii	F	T	F
Carassius_auratus	F	T	F
Careproctus_rhodomelas	T	F	F
Cataetyx_laticeps	T	F	F
Centropomus_undecimalis	T	T	T
Cepola_macrophthalma	T	F	F
Ceratoscopelus_warmingii	T	F	F
Cetengraulis_edentulus	T	F	T
Cetengraulis_mysticetus	T	F	T
Chaca_bankanensis	F	T	F
Chaenopsis_alepidota	T	F	F
Chaetobranchopsis_orbicularis	F	T	F
Chaetobranchus_flavescens	F	T	F
Chalinochromis_brichardi	F	T	F
Champsodon_snyderi	T	F	F
Channa_maculata	F	T	F
Chanodichthys_erythropterus	F	T	F
Chanodichthys_flavipinnis	F	T	F
Chanos_chanos	T	T	T
Characidium_fasciatum	F	T	F
Chascanopsetta_lugubris	T	F	F
Chauliodus_danae	T	F	F
Chauliodus_macouni	T	F	F
Chauliodus_sloani	T	F	F
Cheilodactylus_quadricornis	F	F	F
Cheilodactylus_zonatus	T	F	F
Cheilopogon_heterurus	T	F	F
Chelidonichthys_kumu	T	F	T
Chitala_chitala	F	T	F
Chitala_ornata	F	T	F
Chlopsis_slusserorum	T	F	F
Chlorophthalmus_acutifrons	T	F	F
Chlorurus_sordidus	T	F	T
Choerodon_fasciatus	T	F	F
Chortiheros_wesseli	F	T	F
Chromidotilapia_guntheri	F	T	F
Chromis_nitida	T	F	F
Chromis_viridis	T	F	F
Chrysiptera_brownriggii	T	F	F
Chrysiptera_cyanea	T	F	F
Chrysiptera_rex	T	F	F
Chrysiptera_rollandi	T	F	F
Cichla_intermedia	F	T	F
Cichla_temensis	F	T	F
Cichlasoma_dimerus	F	T	F
Cichlasoma_grammodes	F	T	F
Cichlasoma_orinocense	F	T	F
Cichlasoma_trimaculatum	F	F	F
Cirrhilabrus_punctatus	T	F	F
Cirrhitichthys_falco	T	F	F
Citharoides_macrolepis	T	F	F
Citharus_linguatula	T	F	F
Clarias_gariepinus	F	T	F
Cleithracara_maronii	F	T	F
Clinus_acuminatus	T	F	F
Clinus_agilis	T	F	F
Clinus_cottoides	T	F	F
Clinus_superciliosus	T	F	F
Coilia_dussumieri	T	T	T
Coloconger_raniceps	T	F	F
Coloconger_scholesi	T	F	F
Conger_conger	T	F	F
Conger_japonicus	T	F	F
Congriscus_maldivensis	T	F	F
Congriscus_megastomus	F	F	F
Conocara_salmoneum	T	F	F
Copadichromis_borleyi	F	T	F
Copadichromis_cyaneus	F	T	F
Coptodon_bakossiorum	F	T	F
Coptodon_bemini	F	T	F
Coptodon_bythobates	F	T	F
Coptodon_rendalli	F	T	T
Coptodon_snyderae	F	T	F
Coreoleuciscus_splendidus	F	T	F
Coreoperca_whiteheadi	F	T	T
Coris_gaimard	T	F	F
Coryphaena_equiselis	T	F	F
Coryphaena_hippurus	T	F	F
Coryphaenoides_carapinus	T	F	F
Coryphaenoides_guentheri	T	F	F
Coryphaenoides_leptolepis	T	F	F
Coryphaenoides_profundicolus	T	F	F
Coryphoblennius_galerita	T	F	T
Crenicara_punctulatum	F	F	F
Crenicichla_frenata	F	T	F
Crenicichla_geayi	F	T	F
Crenicichla_hadrostigma	F	T	F
Crenicichla_lugubris	F	T	F
Crenicichla_minuano	F	T	F
Crenicichla_wallacii	F	T	F
Crenicichla_zebrina	F	T	F
Cribroheros_longimanus	F	T	F
Cribroheros_rostratus	F	T	F
Ctenochromis_horei	F	T	F
Ctenolucius_hujeta	F	T	F
Cubiceps_gracilis	T	F	F
Cyathopharynx_furcifer	F	T	F
Cynotilapia_afra	F	T	F
Cynotilapia_pulpican	F	T	F
Cyphotilapia_frontosa	F	T	F
Cyphotilapia_gibberosa	F	T	F
Cyprichromis_coloratus	F	T	F
Cyprichromis_leptosoma	F	T	F
Cyprichromis_microlepidotus	F	T	F
Cyprichromis_pavo	F	T	F
Cyprichromis_zonatus	F	T	F
Dactyloptena_orientalis	T	F	F
Danio_albolineatus	F	T	F
Danio_margaritatus	F	T	F
Danio_rerio	F	T	F
Danio_roseus	F	T	F
Danionella_mirifica	F	T	F
Dascyllus_aruanus	T	F	F
Dascyllus_reticulatus	T	F	F
Dascyllus_trimaculatus	T	F	F
Datnioides_polota	F	T	T
Denticeps_clupeoides	F	T	F
Derichthys_serpentinus	T	F	F
Devario_regina	F	T	F
Diaphus_metopoclampus	T	F	F
Diaphus_rafinesquii	T	F	F
Diaphus_watasei	T	F	F
Dicrossus_filamentosus	F	T	F
Dicrossus_maculatus	F	T	F
Dimidiochromis_compressiceps	F	T	F
Diodon_holocanthus	T	F	F
Diplomystes_nahuelbutaensis	F	T	F
Diplotaxodon_macrops	F	T	F
Dischistodus_perspicillatus	T	F	F
Dischistodus_prosopotaenia	T	F	F
Distichodus_antonii	F	T	F
Ditrema_temminckii	T	F	F
Dorosoma_cepedianum	T	T	T
Dysomma_anguillare	T	F	F
Echeneis_neucratoides	T	F	F
Echiichthys_vipera	T	F	F
Echiodon_cryomargarites	T	F	F
Echiostoma_barbatum	T	F	F
Economidichthys_pygmaeus	F	T	F
Ectodus_descampsii	F	T	F
Eigenmannia_virescens	F	T	F
Elassoma_evergladei	F	T	F
Elassoma_zonatum	F	T	F
Eleutheronema_rhadinum	T	F	F
Ellopostoma_mystax	F	T	F
Elopichthys_bambusa	F	T	F
Elops_saurus	T	F	T
Enchelyopus_cimbrius	T	F	F
Encrasicholina_devisi	F	F	F
Engraulis_encrasicolus	T	F	T
Engraulis_eurystole	T	F	F
Engraulis_japonicus	T	F	F
Engraulis_mordax	T	F	F
Engraulis_ringens	T	F	F
Enteromius_callipterus	F	T	F
Eopsetta_jordani	T	F	F
Epalzeorhynchos_bicolor	F	T	F
Epibulus_insidiator	T	F	F
Epigonus_telescopus	T	F	F
Epinephelus_bruneus	T	F	F
Eretmodus_cyanostictus	F	T	F
Esomus_longimanus	F	T	F
Esox_americanus	F	T	F
Etheostoma_rufilineatum	F	T	F
Eurypharynx_pelecanoides	T	F	F
Eustomias_acinosus	T	F	F
Eustomias_filifer	T	F	F
Eustomias_polyaster	T	F	F
Eustomias_schiffi	T	F	F
Facciolella_equatorialis	T	F	F
Favonigobius_reichei	T	T	T
Flagellostomias_boureei	T	F	F
Gadopsis_marmoratus	F	T	F
Galaxias_maculatus	T	T	T
Gambusia_affinis	F	T	T
Gasterosteus_aculeatus	T	T	T
Gavialiceps_taiwanensis	T	F	F
Geophagus_abalios	F	T	F
Geophagus_brasiliensis	F	T	T
Geophagus_dicrozoster	F	T	F
Geophagus_harreri	F	T	F
Geophagus_steindachneri	F	T	F
Geophagus_taeniopareius	F	T	F
Gibbonsia_elegans	T	F	F
Gibbonsia_montereyensis	T	F	F
Girella_punctata	T	F	F
Gnathanodon_speciosus	T	F	F
Gnathochromis_permaxillaris	F	T	F
Gnathochromis_pfefferi	F	T	F
Gnathonemus_petersii	F	T	F
Gnathophis_heterognathos	T	F	F
Gnathopogon_herzensteini	F	T	F
Gnathopogon_strigatus	F	F	F
Gobiesox_strumosus	T	F	T
Gobio_coriparoides	F	T	F
Gobio_cynocephalus	F	T	F
Gobiobotia_meridionalis	F	T	F
Gobiobotia_pappenheimi	F	T	F
Gobiusculus_flavescens	F	F	F
Gomphosus_varius	T	F	F
Gonostoma_elongatum	T	F	F
Grammatostomias_circularis	T	F	F
Grammatostomias_flagellibarba	T	F	F
Grammatotria_lemairii	F	T	F
Grammicolepis_brachiusculus	T	F	F
Greenwoodochromis_bellcrossi	F	T	F
Guianacara_dacrya	F	T	F
Guianacara_owroewefi	F	T	F
Guianacara_stergiosi	F	T	F
Gymnarchus_niloticus	F	T	F
Gymnocranius_elogatus	F	F	F
Gymnocypris_eckloni	F	T	F
Gymnogeophagus_balzanii	F	T	F
Gymnogeophagus_setequedas	F	T	F
Gymnothorax_buroensis	T	F	F
Gymnothorax_favagineus	T	F	F
Gymnothorax_minor	T	F	F
Gymnothorax_reticularis	T	F	F
Gymnothorax_tile	T	T	T
Gymnotus_carapo	F	T	F
Gymnotus_cylindricus	F	T	F
Gymnotus_tigre	F	T	F
Gyrinocheilus_pennocki	F	T	F
Hainania_serrata	F	T	T
Halichoeres_adustus	T	F	F
Halichoeres_bathyphilus	T	F	F
Halichoeres_bivittatus	T	F	F
Halichoeres_brasiliensis	T	F	F
Halichoeres_burekae	T	F	F
Halichoeres_chierchiae	T	F	F
Halichoeres_chloropterus	T	F	F
Halichoeres_chrysus	T	F	F
Halichoeres_cyanocephalus	T	F	F
Halichoeres_discolor	T	F	F
Halichoeres_dispilus	T	F	F
Halichoeres_garnoti	T	F	F
Halichoeres_maculipinna	T	F	F
Halichoeres_melanotis	T	F	F
Halichoeres_nicholsi	T	F	F
Halichoeres_notospilus	T	T	T
Halichoeres_ornatissimus	T	F	F
Halichoeres_pictus	T	F	F
Halichoeres_poeyi	T	F	F
Halichoeres_radiatus	T	F	F
Halichoeres_rubrovirens	T	F	F
Halichoeres_salmofasciatus	T	F	F
Halichoeres_semicinctus	T	F	F
Halichoeres_socialis	T	F	F
Halosauropsis_macrochir	T	F	F
Halosaurus_ridgwayi	T	F	F
Hampala_macrolepidota	F	T	F
Haplochromis_burtoni	F	F	F
Haplochromis_fischeri	F	T	F
Haplochromis_piceatus	F	T	F
Haplochromis_pyrrhocephalus	F	T	F
Haplochromis_riponianus	F	T	F
Haplochromis_sauvagei	F	T	F
Haplochromis_xenognathus	F	T	F
Haplotaxodon_microlepis	F	T	F
Haplotaxodon_trifasciatus	F	T	F
Harpadon_microchir	T	F	F
Hemibarbus_labeo	F	T	F
Hemibarbus_maculatus	F	T	F
Hemibarbus_mylodon	F	T	F
Hemibates_stenosoma	F	T	F
Hemichromis_fasciatus	F	T	F
Hemiculter_bleekeri	F	T	F
Hemiculter_leucisculus	F	T	T
Hemiculter_lucidus	F	T	F
Hepsetus_odoe	F	T	F
Herichthys_bartoni	F	T	F
Herichthys_cyanoguttatus	F	T	F
Heroina_isonycterina	F	T	F
Heterandria_formosa	F	T	T
Heterophotus_ophistoma	T	F	F
Heteropneustes_fossilis	F	T	F
Heterostichus_rostratus	T	F	F
Heterotilapia_buttikoferi	F	F	F
Himantolophus_groenlandicus	T	F	F
Hime_japonica	T	F	F
Hiodon_alosoides	F	T	F
Hippoglossus_stenolepis	T	F	F
Histiobranchus_bathybius	T	F	F
Holocentrus_rufus	T	F	F
Hoplarchus_psittacus	F	T	F
Hoplias_malabaricus	F	T	F
Hoplostethus_atlanticus	T	F	F
Hoplostethus_mediterraneus	T	F	F
Horadandia_atukorali	F	T	T
Howella_brodiei	T	F	F
Hydrolycus_armatus	F	T	F
Hypleurochilus_aequipinnis	T	F	F
Hypleurochilus_fissicornis	T	F	F
Hypophthalmichthys_molitrix	F	T	T
Hypselecara_coryphaenoides	F	T	F
Hypsophrys_nematopus	F	F	F
Hypsophrys_nicaraguensis	F	T	F
Hypsophrys_unimaculatus	F	T	F
Ichthyococcus_ovatus	T	F	F
Idiacanthus_antrostomus	T	F	F
Idiacanthus_fasciola	T	F	F
Indostomus_paradoxus	F	T	F
Ischikauia_steenackeri	F	T	F
Ivanacara_bimaculata	F	T	F
Jenynsia_onca	F	T	F
Julidochromis_dickfeldi	F	T	F
Julidochromis_marlieri	F	T	F
Julidochromis_ornatus	F	T	F
Jurengraulis_juruensis	F	T	F
Kathetostoma_giganteum	T	F	F
Knipowitschia_milleri	F	T	T
Konia_dikume	F	T	F
Konia_eisentrauti	F	T	F
Krobia_petitella	F	T	F
Krobia_xinguensis	F	T	F
Kronoheros_umbrifer	F	T	F
Kryptopterus_minor	F	T	F
Kuhlia_mugil	T	F	T
Labeotropheus_fuelleborni	F	T	F
Labeotropheus_trewavasae	F	T	F
Labidochromis_caeruleus	F	T	F
Labidochromis_chisumulae	F	T	F
Labrisomus_nuchipinnis	T	F	F
Labroides_dimidiatus	T	F	F
Labrus_bergylta	T	F	F
Lacantunia_enigmatica	F	T	F
Lactarius_lactarius	T	F	T
Ladislavia_taczanowskii	F	T	F
Laetacara_dorsigera	F	T	F
Laetacara_thayeri	F	T	F
Lagocephalus_lagocephalus	T	F	F
Lampanyctus_alatus	T	F	F
Lampris_guttatus	T	F	F
Lamprogrammus_shcherbachevi	T	F	F
Lamprologus_callipterus	F	T	F
Lamprologus_lemairii	F	T	F
Lamprologus_ocellatus	F	T	F
Lates_calcarifer	T	T	T
Lates_niloticus	F	T	F
Latimeria_chalumnae	T	F	F
Latridopsis_ciliaris	T	F	F
Laubuca_dadiburjori	F	T	F
Leiarius_pictus	F	T	F
Leiopotherapon_unicolor	F	T	T
Leocottus_kesslerii	F	T	F
Lepadichthys_lineatus	T	F	F
Lepidiolamprologus_attenuatus	F	T	F
Lepidiolamprologus_cunningtoni	F	F	F
Lepidiolamprologus_elongatus	F	T	F
Lepidiolamprologus_kendalli	F	T	F
Lepidiolamprologus_mimicus	F	T	F
Lepidiolamprologus_nkambae	F	T	F
Lepidiolamprologus_profundicola	F	T	F
Lepidoblepharon_ophthalmolepis	T	F	F
Lepisosteus_oculatus	F	T	T
Leptobarbus_hoevenii	F	T	F
Leptostomias_gladiator	T	F	F
Lestradea_stappersii	F	F	F
Lestrolepis_japonica	T	F	F
Lethrinops_parvidens	F	T	F
Limanda_limanda	T	F	F
Limia_nigrofasciata	F	T	F
Limia_vittata	F	F	F
Limnochromis_abeelei	F	T	F
Limnochromis_staneri	F	T	F
Liosomadoras_morrowi	F	T	F
Lipochromis_melanopterus	F	F	F
Lipogramma_anabantoides	T	F	F
Lipogramma_evides	T	F	F
Lipogramma_klayi	T	F	F
Lipogramma_levinsoni	T	F	F
Lipogramma_trilineata	T	F	F
Lipophrys_pholis	T	F	F
Lipophrys_trigloides	T	F	T
Liza_aurata	T	T	T
Lobochilotes_labiatus	F	F	F
Lophiodes_iwamotoi	T	F	F
Lophiodes_mutilus	T	F	F
Lopholatilus_chamaeleonticeps	T	F	F
Lucania_goodei	F	T	F
Luciosoma_setigerum	F	T	F
Lutjanus_sebae	T	F	T
Luvarus_imperialis	T	F	F
Lycengraulis_batesii	F	T	T
Lycengraulis_grossidens	T	T	T
Lycengraulis_poeyi	T	F	T
Lycodapus_antarcticus	T	F	F
Maccullochella_peelii	F	T	F
Macrocephenchelys_brachialis	T	F	F
Macrocephenchelys_soela	T	F	F
Macruronus_novaezelandiae	T	F	F
Malacosteus_niger	T	F	F
Malapterurus_electricus	F	T	F
Malapterurus_microstoma	F	T	F
Mancopsetta_maculata	T	F	F
Maylandia_zebra	F	T	F
Mazarunia_charadrica	F	T	F
Mazarunia_pala	F	T	F
Meadia_abyssalis	T	F	F
Medialuna_californiensis	T	F	F
Megalobrama_amblycephala	F	T	F
Megalops_atlanticus	T	T	T
Megalops_cyprinoides	T	T	T
Melamphaes_suborbitalis	T	F	F
Melanochromis_auratus	F	T	F
Melanochromis_vermivorus	F	T	F
Melanostomias_bartonbeani	T	F	F
Melanostomias_margaritifer	T	F	F
Melanotaenia_australis	F	T	F
Melanotaenia_lacustris	F	T	F
Menidia_menidia	T	T	T
Merluccius_merluccius	T	F	T
Mesoheros_gephyrus	F	T	F
Mesonauta_egregius	F	T	F
Mesonauta_insignis	F	T	F
Microcanthus_strigatus	T	F	F
Microdevario_kubotai	F	T	F
Microdevario_nana	F	F	F
Microglanis_iheringi	F	T	F
Microlipophrys_adriaticus	F	F	F
Microlipophrys_bauchotae	T	F	F
Microlipophrys_caboverdensis	T	F	F
Microlipophrys_canevae	T	F	F
Microlipophrys_dalmatinus	T	F	F
Microlipophrys_velifer	T	F	F
Microphysogobio_amurensis	F	T	F
Microphysogobio_elongatus	F	T	T
Microphysogobio_longidorsalis	F	T	F
Micropoecilia_bifurca	F	F	F
Micropoecilia_picta	F	F	F
Microrasbora_erythromicron	F	T	F
Microrasbora_rubescens	F	T	F
Microstomus_achne	T	F	F
Mikrogeophagus_altispinosus	F	T	F
Mikrogeophagus_ramirezi	F	T	F
Misgurnus_anguillicaudatus	F	T	F
Monocentris_japonicus	F	F	F
Monopenchelys_acuta	T	F	F
Moringua_macrocephalus	F	T	T
Moringua_microchir	T	F	T
Mormyrops_anguilloides	F	T	F
Morone_saxatilis	T	T	T
Mullus_surmuletus	T	F	T
Muraenesox_cinereus	T	T	T
Muraenoclinus_dorsalis	T	F	F
Myaka_myaka	F	T	F
Mylochromis_lateristriga	F	T	F
Mylopharyngodon_piceus	F	T	F
Myripristis_murdjan	T	F	F
Myrophis_microchir	T	F	F
Nandopsis_haitiensis	F	T	T
Nandopsis_tetracanthus	F	T	T
Nandus_nebulosus	F	T	T
Nannacara_anomala	F	T	F
Nannacara_taenia	F	T	F
Nannatherina_balstoni	F	T	F
Nannoperca_australis	F	T	F
Nannostomus_beckfordi	F	T	F
Naso_lituratus	T	F	F
Nemadactylus_macropterus	T	F	F
Nemadactylus_monodactylus	T	F	F
Nemichthys_curvirostris	T	F	F
Nemichthys_scolopaceus	T	F	F
Nemipterus_aurora	T	F	F
Nemipterus_balinensis	T	F	F
Nemipterus_bathybius	T	F	F
Nemipterus_bipunctatus	T	F	F
Nemipterus_furcosus	T	F	F
Nemipterus_hexodon	T	F	F
Nemipterus_japonicus	T	F	F
Nemipterus_marginatus	T	F	F
Nemipterus_nematophorus	T	F	F
Nemipterus_nematopus	T	F	F
Nemipterus_nemurus	T	F	F
Nemipterus_peronii	T	F	T
Nemipterus_tambuloides	T	F	F
Nemipterus_thosaporni	T	F	F
Nemipterus_virgatus	T	F	F
Nemipterus_zysron	T	F	F
Neobythites_sivicola	T	F	F
Neoceratodus_forsteri	F	T	F
Neochromis_rufocaudalis	F	T	F
Neoglyphidodon_nigroris	T	F	F
Neolamprologus_bifasciatus	F	T	F
Neolamprologus_brichardi	F	T	F
Neolamprologus_buescheri	F	T	F
Neolamprologus_caudopunctatus	F	T	F
Neolamprologus_fasciatus	F	T	F
Neolamprologus_hecqui	F	F	F
Neolamprologus_leleupi	F	T	F
Neolamprologus_modestus	F	T	F
Neolamprologus_obscurus	F	T	F
Neolamprologus_prochilus	F	T	F
Neolamprologus_pulcher	F	T	F
Neolamprologus_sexfasciatus	F	T	F
Neolamprologus_tetracanthus	F	T	F
Neolamprologus_variostigma	F	T	F
Neolamprologus_ventralis	F	T	F
Neopagetopsis_ionah	T	F	F
Neopomacentrus_azysron	T	F	F
Neopomacentrus_bankieri	T	F	F
Neopomacentrus_cyanomos	T	F	F
Neoscopelus_microchir	T	F	F
Nerophis_lumbriciformis	T	F	F
Nessorhamphus_danae	T	F	F
Nettastoma_solitarium	T	F	F
Nimbochromis_fuscotaeniatus	F	T	F
Ninnigobius_canestrinii	F	T	T
Niphon_spinosus	T	F	F
Notacanthus_abbotti	T	F	F
Notacanthus_bonaparte	T	F	F
Notolabrus_celidotus	T	F	F
Odax_pullus	T	F	F
Oncorhynchus_gorbuscha	T	T	T
Oncorhynchus_keta	T	T	T
Oncorhynchus_kisutch	T	T	T
Oncorhynchus_masou	T	T	T
Oncorhynchus_mykiss	T	T	T
Oncorhynchus_nerka	T	T	T
Oncorhynchus_tshawytscha	T	T	T
Ophichthus_machidai	T	F	F
Ophiocara_porocephala	T	T	T
Ophthalmotilapia_nasuta	F	T	F
Ophthalmotilapia_ventralis	F	T	F
Oplegnathus_punctatus	T	F	F
Opsanus_tau	T	F	F
Opsariichthys_bidens	F	T	F
Orectolobus_maculatus	T	F	F
Orectolobus_ornatus	T	F	F
Oreochromis_niloticus	T	T	T
Oreochromis_tanganicae	F	T	T
Oreonectes_platycephalus	F	T	F
Oryzias_latipes	F	T	T
Osmerus_eperlanus	T	T	T
Osteobrama_cotio	F	T	F
Osteobrama_cunma	F	T	F
Osteoglossum_bicirrhosum	F	T	F
Ostorhinchus_quadrifasciatus	F	F	F
Otopharynx_brooksi	F	T	F
Otopharynx_heterodon	F	T	F
Oxyconger_leptognathus	T	F	F
Oxyjulis_californica	F	F	F
Pachystomias_microdon	T	F	F
Pagetopsis_macropterus	T	F	F
Pagrus_auratus	F	F	F
Pagrus_major	T	F	F
Pallidochromis_tokolosh	F	T	F
Pamphorichthys_minor	F	T	F
Pantodon_buchholzi	F	T	F
Parabathymyrus_macrophthalmus	T	F	F
Parablennius_cornutus	T	F	F
Parablennius_gattorugine	T	F	F
Parablennius_incognitus	T	F	F
Parablennius_intermedius	T	F	T
Parablennius_parvicornis	T	F	F
Parablennius_pilicornis	T	F	F
Parablennius_rouxi	T	F	F
Parablennius_ruber	T	F	F
Parablennius_salensis	T	F	F
Parablennius_sanguinolentus	T	F	F
Parablennius_tasmanianus	T	F	T
Parablennius_tentacularis	T	F	T
Parablennius_yatabei	T	F	F
Parablennius_zvonimiri	T	F	T
Parabramis_pekinensis	F	T	F
Parachromis_dovii	F	T	F
Parachromis_managuensis	F	T	F
Paracottus_knerii	F	T	F
Paracyprichromis_brieni	F	T	F
Paracyprichromis_nigripinnis	F	T	F
Parailia_pellucida	F	T	F
Parakneria_cameronensis	F	T	F
Paralabrax_clathratus	T	F	F
Paralaubuca_barroni	F	T	F
Paralaubuca_riveroi	F	T	F
Paralichthys_dentatus	T	F	F
Paralichthys_olivaceus	T	F	T
Parapercis_colias	T	F	F
Paraplagusia_japonica	T	F	F
Parascolopsis_aspinosa	T	F	F
Parascolopsis_eriomma	T	F	F
Parascolopsis_inermis	T	F	F
Parascolopsis_melanophrys	T	F	F
Parascolopsis_tosensis	T	F	F
Parma_oligolepis	T	F	F
Pavoclinus_pavo	T	F	F
Pegusa_lascaris	T	F	T
Pelates_quadrilineatus	T	F	T
Peltorhamphus_latus	T	F	F
Pentapodus_aureofasciatus	T	F	F
Pentapodus_bifasciatus	T	F	F
Pentapodus_caninus	T	F	F
Pentapodus_emeryii	T	F	F
Pentapodus_nagasakiensis	T	F	F
Pentapodus_setosus	T	F	F
Pentapodus_trivittatus	T	F	F
Percalates_colonorum	F	F	F
Percichthys_trucha	F	T	F
Percilia_irwini	F	T	F
Percopsis_omiscomaycus	F	T	F
Periophthalmus_barbarus	T	T	T
Perissodus_eccentricus	F	T	F
Perissodus_microlepis	F	T	F
Perissodus_multidentatus	F	T	F
Petenia_splendida	F	T	F
Petrocephalus_soudanensis	F	T	F
Photoblepharon_palpebratum	T	F	F
Photonectes_braueri	T	F	F
Photonectes_margarita	T	F	F
Photostomias_goodyeari	T	F	F
Photostomias_guernei	T	F	F
Phycis_blennoides	T	T	F
Phycis_phycis	T	F	T
Pimelodus_blochii	F	T	T
Pinguipes_chilensis	T	F	F
Placidochromis_milomo	F	T	F
Placidochromis_polli	F	T	F
Plagiognathops_microlepis	F	T	F
Platytaeniodus_degeni	F	T	F
Plecodus_elaviae	F	T	F
Plecodus_paradoxus	F	T	F
Plecodus_straeleni	F	T	F
Plectroglyphidodon_dickii	T	F	F
Poecilia_caymanensis	F	T	T
Poecilia_latipinna	F	T	T
Poecilia_mexicana	F	T	T
Poecilia_parae	F	T	T
Poecilia_petenensis	F	T	F
Poecilia_reticulata	F	T	T
Poecilia_velifera	F	T	T
Poecilia_wingei	F	T	F
Poecilopsetta_beanii	T	F	F
Poecilopsetta_plinthus	T	F	F
Pollichthys_mauli	T	F	F
Polydactylus_sextarius	T	F	T
Polyipnus_asteroides	T	F	F
Polyipnus_stereope	T	F	F
Polymixia_japonica	T	F	F
Polymixia_lowei	T	F	F
Polyprion_oxygeneios	T	F	F
Pomacanthus_maculosus	T	F	F
Pomacentrus_adelus	T	F	F
Pomacentrus_amboinensis	T	F	F
Pomacentrus_chrysurus	T	F	F
Pomacentrus_coelestis	T	F	F
Pomacentrus_moluccensis	T	F	F
Pomacentrus_nagasakiensis	T	F	F
Pomacentrus_pavo	T	F	F
Pomacentrus_wardi	T	F	F
Pomatoschistus_lozanoi	T	F	T
Pomatoschistus_microps	T	F	T
Pomatoschistus_minutus	T	F	T
Pomatoschistus_pictus	T	F	F
Pontinus_longispinis	T	F	F
Priacanthus_arenatus	T	F	F
Prionurus_scalprum	T	F	F
Procottus_gotoi	F	T	F
Procottus_gurwicii	F	T	F
Procottus_jettelesii	F	F	F
Procottus_major	F	T	F
Protanguilla_palau	T	F	F
Protogobiesox_asymmetricus	T	F	F
Protomelas_similis	F	T	F
Psettodes_erumei	T	T	F
Pseudocrenilabrus_philander	F	T	F
Pseudogobio_esocinus	F	T	F
Pseudogobio_guilinensis	F	T	F
Pseudogobio_vaillanti	F	T	F
Pseudohemiculter_dispar	F	T	T
Pseudolaubuca_engraulis	F	T	F
Pseudophycis_bachus	T	F	F
Pseudopleuronectes_americanus	T	F	F
Pseudorhombus_oligodon	T	F	F
Psilorhynchus_homaloptera	F	T	F
Psilorhynchus_sucatio	F	T	F
Ptereleotris_zebra	T	F	F
Pterengraulis_atherinoides	F	T	T
Pterocaesio_digramma	T	F	F
Pterophyllum_altum	F	T	F
Pterophyllum_leopoldi	F	T	F
Pterophyllum_scalare	F	T	F
Pterycombus_brama	T	F	F
Pundamilia_nyererei	F	T	F
Pungtungia_herzi	F	T	F
Pungu_maclareni	F	T	F
Puntius_titteya	F	T	F
Rachycentron_canadum	T	F	F
Raiamas_buchholzi	F	T	F
Rasbora_bankanensis	F	T	F
Retroculus_xinguensis	F	T	F
Rhadinesthes_decimus	T	F	F
Rhamphichthys_marmoratus	F	T	F
Rhamphochromis_esox	F	T	F
Rhamphochromis_longiceps	F	T	F
Rhinogobio_typus	F	T	T
Rhinomuraena_quaesita	T	F	F
Rhombosolea_leporina	T	F	F
Rhombosolea_plebeia	T	F	F
Rhynchoconger_ectenurus	T	F	F
Rita_rita	F	T	T
Rocio_octofasciata	F	T	F
Romanogobio_ciscaucasicus	F	T	F
Romanogobio_tanaiticus	F	T	F
Romanogobio_tenuicorpus	F	T	F
Saccopharynx_ampullaceus	T	F	F
Sagamichthys_abei	T	F	F
Salaria_fluviatilis	T	T	T
Salaria_pavo	T	T	T
Samaris_cristatus	T	F	F
Samariscus_latus	T	F	F
Sarcocheilichthys_nigripinnis	F	T	F
Sarcocheilichthys_sinensis	F	T	T
Sarcocheilichthys_soldatovi	F	T	F
Sardinella_aurita	T	F	T
Sarotherodon_caroli	F	T	F
Sarotherodon_galilaeus	F	T	T
Sarotherodon_linnellii	F	T	F
Sarotherodon_lohbergeri	F	T	F
Sarotherodon_melanotheron	F	T	T
Sarotherodon_steinbachi	F	T	F
Satanoperca_daemon	F	T	F
Satanoperca_jurupari	F	T	F
Satanoperca_leucosticta	F	T	F
Satanoperca_mapiritensis	F	T	F
Saurida_elongata	T	F	F
Saurogobio_dabryi	F	T	F
Scaevius_milii	T	F	F
Scartella_caboverdiana	T	F	F
Scartella_cristata	T	F	F
Scartella_emarginata	T	F	F
Schedophilus_medusophagus	T	F	F
Schistura_savona	F	T	F
Schizothorax_waltoni	F	T	F
Schultzidia_johnstonensis	T	F	F
Sciaenochromis_fryeri	F	T	F
Scleropages_jardinii	F	T	F
Scolopsis_affinis	T	F	F
Scolopsis_aurata	T	F	F
Scolopsis_bilineata	T	F	F
Scolopsis_bimaculata	T	F	F
Scolopsis_ciliata	T	F	F
Scolopsis_lineata	T	F	F
Scolopsis_margaritifera	T	F	F
Scolopsis_monogramma	T	F	F
Scolopsis_taeniata	T	F	F
Scolopsis_taenioptera	T	F	F
Scolopsis_torquata	T	F	F
Scolopsis_vosmeri	T	F	F
Scolopsis_xenochroa	F	F	F
Scophthalmus_rhombus	T	F	F
Sebastes_alutus	T	F	F
Sebastes_auriculatus	T	F	F
Sebastes_aurora	T	F	F
Sebastes_brevispinis	T	F	F
Sebastes_carnatus	T	F	F
Sebastes_caurinus	T	F	F
Sebastes_chlorostictus	T	F	F
Sebastes_chrysomelas	T	F	F
Sebastes_ciliatus	T	F	F
Sebastes_constellatus	T	F	F
Sebastes_diploproa	T	F	F
Sebastes_elongatus	T	F	F
Sebastes_entomelas	T	F	F
Sebastes_flavidus	T	F	F
Sebastes_hopkinsi	T	F	F
Sebastes_maliger	T	F	F
Sebastes_melanops	T	F	F
Sebastes_melanostomus	T	F	F
Sebastes_miniatus	T	F	F
Sebastes_mystinus	T	F	F
Sebastes_nebulosus	T	F	F
Sebastes_nigrocinctus	T	F	F
Sebastes_ovalis	T	F	F
Sebastes_paucispinis	T	F	F
Sebastes_pinniger	T	F	F
Sebastes_proriger	T	F	F
Sebastes_rosaceus	T	F	F
Sebastes_ruberrimus	T	F	F
Sebastes_rubrivinctus	T	F	F
Sebastes_semicinctus	T	F	F
Sebastes_serranoides	T	F	F
Sebastes_umbrosus	T	F	F
Sebastolobus_altivelis	T	F	F
Selene_dorsalis	T	F	T
Selenotoca_multifasciata	T	T	T
Semaprochilodus_insignis	F	T	F
Seriolella_brama	T	F	F
Serranochromis_macrocephalus	F	T	F
Serrivomer_beanii	T	F	F
Serrivomer_lanceolatoides	T	F	F
Serrivomer_sector	T	F	F
Sewellia_lineolata	F	T	F
Siganus_vulpinus	T	F	F
Sigmops_bathyphilus	T	F	F
Sigmops_gracilis	T	F	F
Sillago_sihama	T	F	T
Silurus_glanis	F	T	F
Sinibrama_macrops	F	T	F
Siniperca_chuatsi	F	T	T
Sinocyclocheilus_anophthalmus	F	T	F
Sinocyclocheilus_furcodorsalis	F	T	F
Sinocyclocheilus_grahami	F	T	T
Sinocyclocheilus_jii	F	T	F
Sinocyclocheilus_jiuxuensis	F	T	F
Sinocyclocheilus_macrolepis	F	T	F
Sinocyclocheilus_macrophthalmus	F	T	F
Sinocyclocheilus_maculatus	F	T	F
Sinocyclocheilus_microphthalmus	F	T	F
Sinocyclocheilus_purpureus	F	T	F
Sinocyclocheilus_qiubeinsis	F	F	F
Sinocyclocheilus_rhinocerous	F	T	F
Sinocyclocheilus_tingi	F	T	F
Sinocyclocheilus_xunlensis	F	T	F
Sinocyclocheilus_yangzongensis	F	T	T
Sinocyclocheilus_yimenensis	F	T	F
Solea_solea	T	F	T
Spathodus_erythrodon	F	T	F
Sphaeramia_nematoptera	T	F	F
Sphyraena_argentea	T	F	F
Spinibarbus_hollandi	F	T	F
Squalidus_argentatus	F	T	T
Squalidus_chankaensis	F	T	F
Squalidus_gracilis	F	T	F
Squalidus_japonicus	F	T	F
Squalidus_wolterstorffi	F	T	T
Steatocranus_casuarius	F	T	F
Steatogenys_elegans	F	T	F
Stegastes_gascoynei	T	F	F
Stenobrachius_leucopsarus	T	F	F
Sternoptyx_pseudobscura	T	F	F
Sternopygus_macrurus	F	T	F
Stigmatochromis_modestus	F	T	F
Stomatepia_mariae	F	T	F
Stomatepia_mongo	F	T	F
Stomatepia_pindu	F	T	F
Stomias_atriventer	T	F	F
Stomias_boa	T	F	F
Stomias_brevibarbatus	T	F	F
Strophidon_sathete	T	T	T
Sundadanio_axelrodi	F	T	F
Symphurus_orientalis	T	F	F
Symphysanodon_katayamai	T	F	F
Symphysodon_discus	F	T	F
Synanceia_verrucosa	T	F	F
Synaphobranchus_affinis	T	F	F
Synaphobranchus_kaupii	T	F	F
Syncrossus_beauforti	F	T	F
Synodontis_membranacea	F	F	F
Synodus_foetens	T	F	T
Tactostoma_macropus	T	F	F
Taeniacara_candidi	F	T	F
Tahuantinsuyoa_macantzatza	F	T	F
Tanichthys_albonubes	F	T	F
Teleocichla_centrarchus	F	T	F
Teleocichla_preta	F	T	F
Telmatochromis_dhonti	F	T	F
Telmatochromis_temporalis	F	T	F
Telmatochromis_vittatus	F	T	F
Terapon_jarbua	T	T	T
Thalassoma_bifasciatum	T	F	F
Thalassoma_lunare	T	F	F
Theraps_irregularis	F	T	F
Thorichthys_helleri	F	T	F
Thorichthys_meeki	F	T	F
Tilapia_sparrmanii	F	T	F
Tomocichla_tuba	F	T	F
Toxabramis_houdemeri	F	T	F
Toxotes_jaculatrix	F	T	T
Trachipterus_arcticus	T	F	F
Trachurus_murphyi	T	F	F
Trachurus_trachurus	T	F	T
Tramitichromis_intermedius	F	T	F
Trematocara_macrostoma	F	T	F
Trematocara_nigrifrons	F	T	F
Trematocara_unimaculatum	F	T	F
Trematochromis_benthicola	F	T	F
Trematomus_bernacchii	T	F	F
Triacanthodes_anomalus	T	F	F
Trichromis_salvini	F	T	F
Trigonolampa_miriceps	T	F	F
Trigonostigma_heteromorpha	F	T	F
Trinectes_maculatus	T	T	T
Triplophos_hemingi	T	F	F
Triplophysa_gundriseri	F	T	F
Tripterygion_delaisi	T	F	F
Tropheus_duboisi	F	T	F
Tropheus_moorii	F	T	F
Tuberoschistura_baenzigeri	F	T	F
Tylochromis_polylepis	F	T	F
Tyrannochromis_maculatus	F	F	F
Uaru_amphiacanthoides	F	T	F
Uaru_fernandezyepezi	F	T	F
Umbra_limi	F	T	F
Uropterygius_fasciolatus	T	F	F
Valenciennea_strigata	T	F	F
Variabilichromis_moorii	F	T	F
Venefica_tentaculata	T	F	F
Verasper_variegatus	T	F	F
Vieja_maculicauda	F	T	T
Vieja_melanura	F	F	F
Vinciguerria_nimbaria	T	F	F
Wajpamheros_nourissati	F	T	F
Xeneretmus_latifrons	T	F	F
Xenochromis_hecqui	F	T	F
Xenomystus_nigri	F	T	F
Xenotilapia_bathyphila	F	F	F
Xenotilapia_boulengeri	F	T	F
Xenotilapia_caudafasciata	F	T	F
Xenotilapia_flavipinnis	F	T	F
Xenotilapia_leptura	F	F	F
Xenotilapia_melanogenys	F	F	F
Xenotilapia_nigrolabiata	F	T	F
Xenotilapia_ochrogenys	F	T	F
Xenotilapia_papilio	F	T	F
Xenotilapia_rotundiventralis	F	F	F
Xenotilapia_sima	F	T	F
Xenotilapia_spiloptera	F	F	F
Xiphias_gladius	T	F	F
Xiphophorus_hellerii	F	T	F
Xyrichtys_novacula	T	F	F
Xystreurys_liolepis	T	F	F
Yaoshanicus_arcus	F	T	F
Yarrella_blackfordi	T	F	F
Yasuhikotakia_morleti	F	T	F
Zanclorhynchus_spinifer	T	F	F
Zeugopterus_punctatus	T	F	F
Zeus_faber	T	F	F
Zoarces_viviparus	T	F	T
